,urls,pageviews,users,new_users,returning_users,clean_url
0,https://companies/news/it-sector-hiring-in-new-age-skills-to-pick-up-in-2021/amp-11605686860932.html,16906,16137,3509,12628,https://companies/news/it-sector-hiring-in-new-age-skills-to-pick-up-in-2021/amp
1,https://market/commodities/gold-prices-today-fall-for-4th-day-in-row-silver-rates-slump-11605754985040.html,5052,4563,2090,2473,https://market/commodities/gold-prices-today-fall-for-4th-day-in-row-silver-rates-slump
2,https://market/stock-market-news/wall-street-us-stocks-decline-as-covid-19-cases-surge-jobless-claims-rise-11605801157893.html,2333,2170,33,2137,https://market/stock-market-news/wall-street-us-stocks-decline-as-covid-19-cases-surge-jobless-claims-rise
3,https://news/india/now-only-50-people-allowed-at-weddings-in-delhi-to-check-covid-19-surge/amp-11605687140134.html,1409,1307,424,883,https://news/india/now-only-50-people-allowed-at-weddings-in-delhi-to-check-covid-19-surge/amp
4,https://news/india/fall-in-exports-surge-in-inflation-puts-india-behind-em-peers/amp-11605684204641.html,954,887,111,776,https://news/india/fall-in-exports-surge-in-inflation-puts-india-behind-em-peers/amp
5,https://Epaper/M/Delhi/19/11/2020/Page/01,726,467,0,467,epaper/M/Delhi/19/11/2020/Page/01
6,https://technology/gadgets/apple-iphone-12-review-an-iterative-update-over-iphone-11-11605525335131.html,602,414,221,193,https://technology/gadgets/apple-iphone-12-review-an-iterative-update-over-iphone-11
7,https://market/market-stats/,514,363,27,336,market/market-stats
8,https://companies/news/tata-group-to-set-up-rs-5000-crore-phone-component-making-unit-in-tn-report-11603867877879.html,433,399,250,149,https://companies/news/tata-group-to-set-up-rs-5000-crore-phone-component-making-unit-in-tn-report
9,https://companies/news/govt-yet-to-decide-on-international-arbitration-appeal-in-voda-retro-tax-case/amp-11605611679333.html,352,336,94,242,https://companies/news/govt-yet-to-decide-on-international-arbitration-appeal-in-voda-retro-tax-case/amp
10,https://companies/news/dhfl-lenders-looking-to-repay-55-000-fd-holders-under-resolution-plan-11605609424712.html,305,231,68,163,https://companies/news/dhfl-lenders-looking-to-repay-55-000-fd-holders-under-resolution-plan
11,https://money/personal-finance/lvb-moratorium-things-that-depositors-shareholders-and-borrowers-need-to-know-11605693227416.html,279,226,70,156,https://money/personal-finance/lvb-moratorium-things-that-depositors-shareholders-and-borrowers-need-to-know
12,https://brand-post/collegedunia-emerges-as-a-market-leader-with-revenue-crossing-70m-in-fy-2020/amp-11605786605447.html,257,226,131,95,https://brand-post/collegedunia-emerges-as-a-market-leader-with-revenue-crossing-70m-in-fy-2020/amp
13,https://politics/news/loan-moratorium-sc-asks-power-producers-to-file-suggestions-on-relief-measures-11605779165730.html,232,212,78,134,https://politics/news/loan-moratorium-sc-asks-power-producers-to-file-suggestions-on-relief-measures
14,https://news/india/cbse-class-12-check-deleted-chapters-syllabus-revised-for-arts-science-commerce-11594181767618.html,214,148,119,29,https://news/india/cbse-class-12-check-deleted-chapters-syllabus-revised-for-arts-science-commerce
15,https://news/india/news-reports-of-indian-army-action-in-pok-fake-dgmo/amp-11605799021688.html,196,182,60,122,https://news/india/news-reports-of-indian-army-action-in-pok-fake-dgmo/amp
16,https://market/commodities/gold-prices-fall-rs-1000-in-minutes-after-pfizer-says-covid-vaccine-effective/amp-11604924687541.html,179,150,59,91,https://market/commodities/gold-prices-fall-rs-1000-in-minutes-after-pfizer-says-covid-vaccine-effective/amp
17,https://market/stock-market-news/nifty-edges-closer-to-13000-as-record-setting-rally-continues-what-analysts-say-11605699193572.html,165,140,26,114,https://market/stock-market-news/nifty-edges-closer-to-13000-as-record-setting-rally-continues-what-analysts-say
18,https://news/india/-saddened-by-the-accident-in-vadodara-pm-modi-expresses-grief-11605678609544.html,156,154,14,140,https://news/india/-saddened-by-the-accident-in-vadodara-pm-modi-expresses-grief
19,https://Epaper/M/Delhi/19/11/2020/Page/05,143,110,0,110,epaper/M/Delhi/19/11/2020/Page/05
20,https://market/stock-market-news/analysts-positive-on-consumption-sector-recommend-these-two-stocks/amp-11605749431595.html,133,129,7,122,https://market/stock-market-news/analysts-positive-on-consumption-sector-recommend-these-two-stocks/amp
21,https://news/india/mbbs-courses-kerala-to-move-supreme-court-against-high-fee-structure/amp-11605762678745.html,124,120,27,93,https://news/india/mbbs-courses-kerala-to-move-supreme-court-against-high-fee-structure/amp
22,https://news/india/who-all-can-fly-abroad-and-which-countries-from-india-new-international-travel-rules-here-11603676272956.html,115,103,63,40,https://news/india/who-all-can-fly-abroad-and-which-countries-from-india-new-international-travel-rules-here
23,https://news/india/-public-health-spending-should-go-up-to-2-5-of-gdp-by-2024-11605756413154.html,108,99,24,75,https://news/india/-public-health-spending-should-go-up-to-2-5-of-gdp-by-2024
24,https://brand-stories/intelligent-pcs-that-learn-from-you-11603190211969.html,102,76,15,61,https://brand-stories/intelligent-pcs-that-learn-from-you
25,https://news/world/china-detects-covid-19-on-frozen-beef-shrimp-from-various-countries-sounds-alarm-11605418815448.html,97,80,37,43,https://news/world/china-detects-covid-19-on-frozen-beef-shrimp-from-various-countries-sounds-alarm
26,https://news/world/to-help-economy-bank-proposes-5-tax-for-employees-working-from-home/amp-11605202587063.html,93,85,26,59,https://news/world/to-help-economy-bank-proposes-5-tax-for-employees-working-from-home/amp
27,https://money/personal-finance/divorce-and-money-rights/amp-1556205599799.html,89,86,49,37,money/personal-finance/divorce-and-money-rights/amp-1556205599799.html
28,https://news/india/registration-of-construction-worker-through-door-step-delivery-in-delhi-manish-sisodia-11605773319764.html,85,75,8,67,https://news/india/registration-of-construction-worker-through-door-step-delivery-in-delhi-manish-sisodia
29,https://companies/news/deal-with-ssab-likely-to-aid-tata-steel-s-europe-revival-11605491650854.html,81,73,51,22,https://companies/news/deal-with-ssab-likely-to-aid-tata-steel-s-europe-revival
30,https://Object/o6mURyu9oxYAJoovrnFH1M/subscribe.html,77,62,24,38,object/o6mURyu9oxYAJoovrnFH1M/subscribe.html
31,https://news/india/india-ranks-77-in-global-bribery-risk-matrix-11605785059833.html,74,57,15,42,https://news/india/india-ranks-77-in-global-bribery-risk-matrix
32,https://market/stock-market-news/here-are-the-top-10-highest-dividend-paying-stocks/amp-11598589134087.html,71,61,30,31,https://market/stock-market-news/here-are-the-top-10-highest-dividend-paying-stocks/amp
33,https://news/world/covid-19-racial-tension-climate-disasters-worsening-us-housing-inequality-11605762318745.html,69,64,44,20,https://news/world/covid-19-racial-tension-climate-disasters-worsening-us-housing-inequality
34,https://market/stock-market-news/-keep-the-faith-morgan-stanley-has-a-positive-outlook-for-stocks-for-next-year-11605498738433.html,66,51,9,42,https://market/stock-market-news/-keep-the-faith-morgan-stanley-has-a-positive-outlook-for-stocks-for-next-year
35,https://news/india/un-report-cites-isro-efforts-in-assisting-indian-government-to-contain-covid-19-11605767545096.html,64,57,17,40,https://news/india/un-report-cites-isro-efforts-in-assisting-indian-government-to-contain-covid-19
36,https://Money/UfPYjEHW8Ksf38hbzHSQXK/where-you-can-exchange-your-damaged-notes-Rs-2000-Rs-200.html?facet=amp,60,55,40,15,money/UfPYjEHW8Ksf38hbzHSQXK/where-you-can-exchange-your-damaged-notes-Rs-2000-Rs-200.html?facet=amp
37,https://news/world/elon-musk-is-just-a-tesla-inc-rally-away-becoming-world-s-second-richest/amp-11605759781566.html,59,57,10,47,https://news/world/elon-musk-is-just-a-tesla-inc-rally-away-becoming-world-s-second-richest/amp
38,https://news/world/china-all-set-to-change-its-development-model-from-2021-xi-11605786929992.html,57,49,9,40,https://news/world/china-all-set-to-change-its-development-model-from-2021-xi
39,https://Home/MShareArticle?OrgId=1911ab35f599&imageview=0,54,48,0,48,home/MShareArticle?OrgId=1911ab35f599&imageview=0
40,https://industry/media/netflix-may-launch-new-cheaper-subscription-plans-in-india-here-s-a-sneak-peek-11576228880338.html,53,48,39,9,https://industry/media/netflix-may-launch-new-cheaper-subscription-plans-in-india-here-s-a-sneak-peek
41,https://money/personal-finance/employee-provident-fund-epf-four-ways-to-check-your-account-balance-11596086820453.html,52,35,27,8,https://money/personal-finance/employee-provident-fund-epf-four-ways-to-check-your-account-balance
42,https://technology/tech-news/google-announces-new-features-for-apple-iphone-users/amp-11603618898441.html,51,44,36,8,https://technology/tech-news/google-announces-new-features-for-apple-iphone-users/amp
43,https://education/news/maharashtra-govt-postpones-mpsc-2020-exam-new-dates-to-be-released-soon/amp-11602251523661.html,49,49,42,7,https://education/news/maharashtra-govt-postpones-mpsc-2020-exam-new-dates-to-be-released-soon/amp
44,https://money/personal-finance/nhai-rec-cut-interest-on-capital-gains-bonds/amp-11596365448526.html,48,46,12,34,https://money/personal-finance/nhai-rec-cut-interest-on-capital-gains-bonds/amp
45,https://money/personal-finance/what-happens-if-you-don-t-file-income-tax-return-itr-penalty-or-even-jail/amp-11597290432835.html,47,46,21,25,https://money/personal-finance/what-happens-if-you-don-t-file-income-tax-return-itr-penalty-or-even-jail/amp
46,https://news/india/flights-start-from-bihar-s-darbhanga-airport-to-delhi-mumbai-bengaluru/amp-11604889374463.html,46,42,23,19,https://news/india/flights-start-from-bihar-s-darbhanga-airport-to-delhi-mumbai-bengaluru/amp
47,https://news/india/indian-economy-will-see-double-digit-growth-next-fiscal-virmani-11605709306698.html,45,37,8,29,https://news/india/indian-economy-will-see-double-digit-growth-next-fiscal-virmani
48,https://news/india/validity-of-driving-licences-and-motor-vehicle-documents-extended-till-31-dec/amp-11598266399172.html,44,39,18,21,https://news/india/validity-of-driving-licences-and-motor-vehicle-documents-extended-till-31-dec/amp
49,https://money/personal-finance/rupee-replaces-stable-coins-in-india-s-crypto-market-11599546170560.html,43,32,25,7,https://money/personal-finance/rupee-replaces-stable-coins-in-india-s-crypto-market
50,https://politics/news/telangana-bjp-appoints-bhupender-yadav-as-election-incharge-for-upcoming-ghmc-polls/amp-11605444842521.html,42,39,24,15,https://politics/news/telangana-bjp-appoints-bhupender-yadav-as-election-incharge-for-upcoming-ghmc-polls/amp
51,https://auto-news/meteor-350-launch-live-check-price-features-of-royal-enfield-s-new-bike/amp-11604640527953.html,40,38,21,17,https://auto-news/meteor-350-launch-live-check-price-features-of-royal-enfield-s-new-bike/amp
52,https://Companies/An8gaUSRQoMFK3GlhHneaP/How-to-cancel-tickets-bought-at-counters-online-through-IRCT.html,39,29,23,6,companies/An8gaUSRQoMFK3GlhHneaP/How-to-cancel-tickets-bought-at-counters-online-through-IRCT.html
53,https://news/india/rbi-appoints-kris-gopalakrishnan-as-chairperson-of-reserve-bank-innovation-hub-11605603149468.html,39,37,19,18,https://news/india/rbi-appoints-kris-gopalakrishnan-as-chairperson-of-reserve-bank-innovation-hub
54,https://money/personal-finance/epfo-new-rule-deposit-linked-insurance-benefits-hiked-to-rs-7-lakh-11599653805345.html,38,29,20,9,https://money/personal-finance/epfo-new-rule-deposit-linked-insurance-benefits-hiked-to-rs-7-lakh
55,https://money/ask-mint-money,37,32,3,29,money/ask-mint-money
56,https://companies/news/fidelity-renews-300-000-sq-ft-office-space-in-xander-s-bengaluru-property/amp-11605784876912.html,36,34,13,21,https://companies/news/fidelity-renews-300-000-sq-ft-office-space-in-xander-s-bengaluru-property/amp
57,https://science/health/decoded-how-smoking-worsens-coronavirus-infection/amp-11605754426566.html,36,33,15,18,https://science/health/decoded-how-smoking-worsens-coronavirus-infection/amp
58,https://news/world/elon-musk-tweets-he-most-likely-has-moderate-case-of-covid-19/amp-11605401365495.html,35,31,24,7,https://news/world/elon-musk-tweets-he-most-likely-has-moderate-case-of-covid-19/amp
59,https://news/india/going-to-kerala-here-are-the-new-rules-for-entry-into-state-11592205369530.html,34,31,24,7,https://news/india/going-to-kerala-here-are-the-new-rules-for-entry-into-state
60,https://industry/advertising/adidas-india-launches-reusable-face-masks-across-75-cities/amp-11592222358215.html,33,32,18,14,https://industry/advertising/adidas-india-launches-reusable-face-masks-across-75-cities/amp
61,https://news/india/irctc-special-train-reservation-booking-cancellation-rac-new-rules-explained/amp-11589264869127.html,33,30,17,13,https://news/india/irctc-special-train-reservation-booking-cancellation-rac-new-rules-explained/amp
62,https://money/personal-finance/epf-withdrawal-rules-when-can-you-partially-withdraw-your-pf-money/amp-1559903682006.html,32,28,11,17,money/personal-finance/epf-withdrawal-rules-when-can-you-partially-withdraw-your-pf-money/amp-1559903682006.html
63,https://Leisure/Mtxy3Pg73Kp0CeINtSSrfI/10-measures-to-assess-fire-safety.html,31,27,25,2,leisure/Mtxy3Pg73Kp0CeINtSSrfI/10-measures-to-assess-fire-safety.html
64,https://news/india/-zoom-dysmorphia-leading-people-to-rush-for-facial-treatments-experts-11605514319729.html,31,25,15,10,https://news/india/-zoom-dysmorphia-leading-people-to-rush-for-facial-treatments-experts
65,https://industry/human-resource/tcs-stays-bullish-on-campus-hiring-11600474724638.html,30,29,19,10,https://industry/human-resource/tcs-stays-bullish-on-campus-hiring
66,https://news/world/us-weekly-jobless-claims-rise-covid-surge-seen-slowing-labour-market-healing-11605798028078.html,30,27,15,12,https://news/world/us-weekly-jobless-claims-rise-covid-surge-seen-slowing-labour-market-healing
67,https://mint-lounge/features/an-exclusive-look-at-rujuta-diwekar-s-12-week-fitness-project-11578072655920.html,29,22,20,2,https://mint-lounge/features/an-exclusive-look-at-rujuta-diwekar-s-12-week-fitness-project
68,https://Money/QkYShk1Sgr5DHR3POr8UEJ/5-metrics-to-evaluate-life-insurance-business.html,28,25,14,11,money/QkYShk1Sgr5DHR3POr8UEJ/5-metrics-to-evaluate-life-insurance-business.html
69,https://money/personal-finance/what-you-could-lose-if-you-cancel-a-property-booking-11590606421678.html,28,24,14,10,https://money/personal-finance/what-you-could-lose-if-you-cancel-a-property-booking
70,https://Money/FqleC1b2BAZFBwVPow32NP/Did-you-know-how-to-obtain-a-true-or-certified-copy-of-prop.html?facet=amp,27,27,14,13,money/FqleC1b2BAZFBwVPow32NP/Did-you-know-how-to-obtain-a-true-or-certified-copy-of-prop.html?facet=amp
71,https://money/personal-finance/failed-atm-transaction-refund-time-key-things-to-know-11602134385012.html,27,24,13,11,https://money/personal-finance/failed-atm-transaction-refund-time-key-things-to-know
72,https://technology/apps/whatsapp-gets-a-new-shopping-button-how-it-works-11605010824029.html,27,11,3,8,https://technology/apps/whatsapp-gets-a-new-shopping-button-how-it-works
73,https://mint-lounge/business-of-life/behind-a-great-ceo-is-an-executive-assistant-1562599429102.html,26,24,23,1,mint-lounge/business-of-life/behind-a-great-ceo-is-an-executive-assistant-1562599429102.html
74,https://news/india/these-4-indian-airports-figure-in-the-list-of-world-s-top-100/amp-11589259675498.html,26,24,14,10,https://news/india/these-4-indian-airports-figure-in-the-list-of-world-s-top-100/amp
75,https://companies/news/low-cost-norwegian-air-shuttle-files-for-bankruptcy-protection/amp-11605719606767.html,25,22,16,6,https://companies/news/low-cost-norwegian-air-shuttle-files-for-bankruptcy-protection/amp
76,https://mutual-fund/mf-news/10-favourite-stocks-of-mutual-funds/amp-11595053646939.html,25,21,4,17,https://mutual-fund/mf-news/10-favourite-stocks-of-mutual-funds/amp
77,https://Money/wE4nhRE75zJ1yRZL1mYECJ/How-much-tax-is-applicable-on-pension-and-family-pension.html?facet=amp,24,22,12,10,money/wE4nhRE75zJ1yRZL1mYECJ/How-much-tax-is-applicable-on-pension-and-family-pension.html?facet=amp
78,https://money/personal-finance/you-may-still-have-to-visit-your-bank-branch-for-making-high-value-transactions-11599715103435.html,24,21,12,9,https://money/personal-finance/you-may-still-have-to-visit-your-bank-branch-for-making-high-value-transactions
79,https://Industry/NB1ERlRA7xePMoH3535xiP/United-Breweries-launches-Amstel-beer-in-India-looks-to-tak.html?facet=amp,23,21,11,10,industry/NB1ERlRA7xePMoH3535xiP/United-Breweries-launches-Amstel-beer-in-India-looks-to-tak.html?facet=amp
80,https://market/market-stats/bse-top-losers,23,18,1,17,market/market-stats/bse-top-losers
81,https://news/india/p-b-nooh-a-man-with-a-gift-for-instant-decision-making-at-kerala-s-ground-zero-of-crisis/amp-11584733870269.html,23,19,12,7,https://news/india/p-b-nooh-a-man-with-a-gift-for-instant-decision-making-at-kerala-s-ground-zero-of-crisis/amp
82,https://Politics/7cIwTCqENzczNfxTojteNL/Toll-on-Yamuna-Expressway-hiked.html,22,21,16,5,politics/7cIwTCqENzczNfxTojteNL/Toll-on-Yamuna-Expressway-hiked.html
83,https://money/personal-finance/india-s-first-reit-is-finally-here-should-you-invest/amp-1552826505402.html,22,22,12,10,money/personal-finance/india-s-first-reit-is-finally-here-should-you-invest/amp-1552826505402.html
84,https://technology/tech-news/apple-iphone-11-hdfc-offers-rs-6-000-discount-effective-price-can-be-rs-39-300-1569484287050.html,22,21,13,8,technology/tech-news/apple-iphone-11-hdfc-offers-rs-6-000-discount-effective-price-can-be-rs-39-300-1569484287050.html
85,https://education/news/students-in-class-10-12-to-not-have-final-exams-in-2021-will-be-allowed-to-pass-west-bengal-cm-mamata-11605094598163.html,21,17,10,7,https://education/news/students-in-class-10-12-to-not-have-final-exams-in-2021-will-be-allowed-to-pass-west-bengal-cm-mamata
86,https://money/personal-finance/with-11-returns-nps-tier-ii-outshines-bank-fds-liquid-funds-11600847170287.html,21,20,7,13,https://money/personal-finance/with-11-returns-nps-tier-ii-outshines-bank-fds-liquid-funds
87,https://technology/tech-news/newly-launched-apple-online-store-in-india-gives-exchange-offers-student-discounts-and-more-all-you-need-to-know-11600851081900.html,21,20,15,5,https://technology/tech-news/newly-launched-apple-online-store-in-india-gives-exchange-offers-student-discounts-and-more-all-you-need-to-know
88,https://companies/bharat-petroleum-privatisation-govt-to-provide-rules-on-employee-protection-asset-stripping-later/amp-11599389747900.html,20,19,9,10,https://companies/bharat-petroleum-privatisation-govt-to-provide-rules-on-employee-protection-asset-stripping-later/amp
89,https://money/personal-finance/epf-account-how-to-submit-e-nomination-at-epfo-1568714932550.html,20,19,17,2,money/personal-finance/epf-account-how-to-submit-e-nomination-at-epfo-1568714932550.html
90,https://news/india/mumbai-maldives-cruise-booking-ticket-price-package-other-details/amp-11570081968917.html,20,18,9,9,https://news/india/mumbai-maldives-cruise-booking-ticket-price-package-other-details/amp
91,https://Industry/T3XIiwJI31WZuK1IsoUOJL/How-safe-are-sanitary-pads-in-India.html?facet=amp,19,17,9,8,industry/T3XIiwJI31WZuK1IsoUOJL/How-safe-are-sanitary-pads-in-India.html?facet=amp
92,https://companies/news/covid-19-vaccine-zydus-cadila-plans-to-boost-capacity-by-70-11603755752588.html,19,18,11,7,https://companies/news/covid-19-vaccine-zydus-cadila-plans-to-boost-capacity-by-70
93,https://money/personal-finance/different-gst-rates-are-applicable-to-different-life-insurance-plans-11577021230202.html,19,18,14,4,https://money/personal-finance/different-gst-rates-are-applicable-to-different-life-insurance-plans
94,https://news/india/india-china-agree-on-three-step-disengagement-plan-from-pangong-lake-area-11605079654893.html,19,11,1,10,https://news/india/india-china-agree-on-three-step-disengagement-plan-from-pangong-lake-area
95,https://Companies/eJNeDPiZg6v9FGfTrq57ZK/New-Cadbury-Dairy-Milk-ad-celebrates-its-70-years-in-India.html,18,15,10,5,companies/eJNeDPiZg6v9FGfTrq57ZK/New-Cadbury-Dairy-Milk-ad-celebrates-its-70-years-in-India.html
96,https://budget/economic-survey/it-s-easier-doing-business-in-india-now-but-starting-up-is-still-hard-to-do-11580492222123.html,18,16,8,8,https://budget/economic-survey/it-s-easier-doing-business-in-india-now-but-starting-up-is-still-hard-to-do
97,https://mint-lounge/features/gunjan-saxena-and-sexism-in-the-indian-air-force/amp-11597337904499.html,18,14,11,3,https://mint-lounge/features/gunjan-saxena-and-sexism-in-the-indian-air-force/amp
98,https://news/india/india-s-active-covid-cases-drop-closer-to-5-lakh-as-recoveries-outpace-new-case-11604894476053.html,18,3,0,3,https://news/india/india-s-active-covid-cases-drop-closer-to-5-lakh-as-recoveries-outpace-new-case
99,https://opinion/columns/opinion-why-women-are-still-being-treated-as-unequal-to-men/amp-1567002359177.html,18,18,15,3,opinion/columns/opinion-why-women-are-still-being-treated-as-unequal-to-men/amp-1567002359177.html
100,https://Politics/rcsu24yGQ0frdanyQ9fVVL/All-you-need-to-know-about-NJAC.html,17,13,8,5,politics/rcsu24yGQ0frdanyQ9fVVL/All-you-need-to-know-about-NJAC.html
101,https://industry/banking/indian-banks-are-in-for-a-20-trillion-hole/amp-11594908292074.html,17,16,5,11,https://industry/banking/indian-banks-are-in-for-a-20-trillion-hole/amp
102,https://money/personal-finance/sbi-mega-e-auction-for-properties-across-the-country-tomorrow-check-eligibility-how-to-apply/amp-11601384681192.html,17,17,11,6,https://money/personal-finance/sbi-mega-e-auction-for-properties-across-the-country-tomorrow-check-eligibility-how-to-apply/amp
103,https://news/india/page-4,17,14,0,14,news/india/page-4
104,https://topic/debt-funds,17,12,1,11,topic/debt-funds
105,https://Politics/Yd2EAFIupVHDX0EbUdecsO/One-in-three-households-in-India-owns-a-twowheeler.html,16,12,7,5,politics/Yd2EAFIupVHDX0EbUdecsO/One-in-three-households-in-India-owns-a-twowheeler.html
106,https://industry/telecom/jio-s-rs-149-recharge-plan-data-offer-validity-period-changed/amp-11573636408439.html,16,16,13,3,https://industry/telecom/jio-s-rs-149-recharge-plan-data-offer-validity-period-changed/amp
107,https://money/personal-finance/now-paytm-users-have-to-pay-2-charge-on-using-credit-cards-to-top-up-wallets-11602944126802.html,16,16,6,10,https://money/personal-finance/now-paytm-users-have-to-pay-2-charge-on-using-credit-cards-to-top-up-wallets
108,https://news/india/delhi-plasma-bank-over-700-covid-19-patients-get-plasma/amp-11597200496686.html,16,16,13,3,https://news/india/delhi-plasma-bank-over-700-covid-19-patients-get-plasma/amp
109,https://news/world/obama-says-us-adversaries-already-see-a-weakened-country-11605489161301.html,16,13,3,10,https://news/world/obama-says-us-adversaries-already-see-a-weakened-country
110,https://Home/ShareArticle?OrgId=1911d64116fb&imageview=0,15,15,0,15,home/ShareArticle?OrgId=1911d64116fb&imageview=0
111,https://companies/news/20-most-profitable-firms-in-india-generate-70-of-country-s-profits/amp-11589766746084.html,15,15,8,7,https://companies/news/20-most-profitable-firms-in-india-generate-70-of-country-s-profits/amp
112,https://market/commodities/gold-prices-today-higher-but-down-rs-5-000-from-record-highs-silver-rates-surge/amp-11603767598670.html,15,10,4,6,https://market/commodities/gold-prices-today-higher-but-down-rs-5-000-from-record-highs-silver-rates-surge/amp
113,https://money/personal-finance/nps-tier-ii-account-income-tax-benefits-rules-for-govt-employees-released/amp-11597908437590.html,15,13,4,9,https://money/personal-finance/nps-tier-ii-account-income-tax-benefits-rules-for-govt-employees-released/amp
114,https://news/india/how-fraudsters-are-using-fake-ids-to-travel-in-mumbai-local-train/amp-11601967219022.html,15,15,7,8,https://news/india/how-fraudsters-are-using-fake-ids-to-travel-in-mumbai-local-train/amp
115,https://opinion/columns/opinion-why-women-are-still-being-treated-as-unequal-to-men-1567002359177.html,15,15,15,0,opinion/columns/opinion-why-women-are-still-being-treated-as-unequal-to-men-1567002359177.html
116,https://Money/BFvKL47eat3BzCy2RYVO7O/Monetary-policy-tools-that-RBI-uses.html,14,11,6,5,money/BFvKL47eat3BzCy2RYVO7O/Monetary-policy-tools-that-RBI-uses.html
117,https://auto-news/honda-launches-new-200cc-hornet-2-0-price-features-other-details/amp-11598520561539.html,14,14,13,1,https://auto-news/honda-launches-new-200cc-hornet-2-0-price-features-other-details/amp
118,https://market/mark-to-market/a-battered-indusind-bank-lays-bare-rbi-s-financial-stability-challenge-11585634396063.html,14,12,6,6,https://market/mark-to-market/a-battered-indusind-bank-lays-bare-rbi-s-financial-stability-challenge
119,https://money/personal-finance/income-tax-department-releases-data-on-crorepati-taxpayers-11571134760274.html,14,13,8,5,https://money/personal-finance/income-tax-department-releases-data-on-crorepati-taxpayers
120,https://news/india/adani-group-takes-over-ahmedabad-airport-operations-from-today/amp-11604820092678.html,14,13,8,5,https://news/india/adani-group-takes-over-ahmedabad-airport-operations-from-today/amp
121,https://news/india/maharashtra-stamp-duty-cut-to-encourage-fence-sitters-in-making-purchase-decisions-say-realtors/amp-11598788211886.html,14,14,6,8,https://news/india/maharashtra-stamp-duty-cut-to-encourage-fence-sitters-in-making-purchase-decisions-say-realtors/amp
122,https://politics/news/mallikarjun-kharge-hits-out-at-those-weakening-cong-from-within-by-attacking-leadership/amp-11605795925148.html,14,12,2,10,https://politics/news/mallikarjun-kharge-hits-out-at-those-weakening-cong-from-within-by-attacking-leadership/amp
123,https://Epaper/M/Delhi/18/11/2020/Page/02,13,8,0,8,epaper/M/Delhi/18/11/2020/Page/02
124,https://Sundayapp/clQnX60MIR2LhCitpMmMWO/Indias-refugee-saga-from-1947-to-2017.html,13,10,7,3,sundayapp/clQnX60MIR2LhCitpMmMWO/Indias-refugee-saga-from-1947-to-2017.html
125,https://companies/news/ril-to-invest-up-to-50-mn-in-bill-gates-owned-breakthrough-energy-ventures/amp-11605195386475.html,13,11,3,8,https://companies/news/ril-to-invest-up-to-50-mn-in-bill-gates-owned-breakthrough-energy-ventures/amp
126,https://industry/telecom/travelling-abroad-airtel-revises-international-roaming-packs-details-here/amp-11582698431841.html,13,13,4,9,https://industry/telecom/travelling-abroad-airtel-revises-international-roaming-packs-details-here/amp
127,https://money/personal-finance/gold-taxation-how-gold-jewellery-digital-gold-sovereign-gold-bonds-are-taxed-11598059614958.html,13,13,5,8,https://money/personal-finance/gold-taxation-how-gold-jewellery-digital-gold-sovereign-gold-bonds-are-taxed
128,https://mutual-fund/mf-news/what-happens-when-you-miss-sip-payment/amp-11598058006578.html,13,13,5,8,https://mutual-fund/mf-news/what-happens-when-you-miss-sip-payment/amp
129,https://news/india/indian-army-to-begin-recruitment-rally-on-15-jan-in-telangana-s-secunderabad-11605263755881.html,13,13,11,2,https://news/india/indian-army-to-begin-recruitment-rally-on-15-jan-in-telangana-s-secunderabad
130,https://news/world/ukraine-s-health-minister-tests-positive-for-covid-19-as-cases-rise-11605402155762.html,13,11,1,10,https://news/world/ukraine-s-health-minister-tests-positive-for-covid-19-as-cases-rise
131,https://topic/amp-npa,13,11,5,6,topic/amp-npa
132,https://Leisure/5HXETKMurtzj0QEK6Ppf6K/10-Indian-embroidery-traditions-that-make-a-serious-style-st.html?facet=amp,12,11,7,4,leisure/5HXETKMurtzj0QEK6Ppf6K/10-Indian-embroidery-traditions-that-make-a-serious-style-st.html?facet=amp
133,https://Search/Link/Author/Amit-Panday,12,9,1,8,search/Link/Author/Amit-Panday
134,https://companies/news/india-s-online-video-market-to-touch-4-billion-by-2025-11589795634495.html,12,10,2,8,https://companies/news/india-s-online-video-market-to-touch-4-billion-by-2025
135,https://industry/media/cadbury-5-star-do-nothing-ad-draws-flak-for-insensitive-portrayal-of-youth/amp-11578120522821.html,12,10,6,4,https://industry/media/cadbury-5-star-do-nothing-ad-draws-flak-for-insensitive-portrayal-of-youth/amp
136,https://money/personal-finance/beware-of-card-cloning-devices-when-using-your-atm-card/amp-11594285260378.html,12,11,8,3,https://money/personal-finance/beware-of-card-cloning-devices-when-using-your-atm-card/amp
137,https://money/personal-finance/ppf-account-why-investors-should-be-aware-of-form-h-11571225519404.html,12,10,3,7,https://money/personal-finance/ppf-account-why-investors-should-be-aware-of-form-h
138,https://news/india/decoding-the-great-indian-taxpayer-11571680784279.html,12,12,7,5,https://news/india/decoding-the-great-indian-taxpayer
139,https://news/india/pli-scheme-might-lead-to-new-investments-in-auto-sector-say-industry-experts/amp-11605105484530.html,12,10,2,8,https://news/india/pli-scheme-might-lead-to-new-investments-in-auto-sector-say-industry-experts/amp
140,https://opinion/columns/the-trojan-horse-of-a-trade-pact-that-india-should-guard-against/amp-11572788673795.html?__twitter_impression=true,12,9,4,5,https://opinion/columns/the-trojan-horse-of-a-trade-pact-that-india-should-guard-against/amp-11572788673795.html?__twitter_impression=true
141,https://Companies/sBkxMex3yEnvPoX7vzdyBN/Flipkart-Rivigo-in-Interbrands-top-emerging-brands-list.html,11,9,9,0,companies/sBkxMex3yEnvPoX7vzdyBN/Flipkart-Rivigo-in-Interbrands-top-emerging-brands-list.html
142,https://Money/QbmTImlNsGmgil7dRvNzPJ/Now-UPI-allows-you-to-transfer-money-from-one-bank-account-t.html,11,10,5,5,money/QbmTImlNsGmgil7dRvNzPJ/Now-UPI-allows-you-to-transfer-money-from-one-bank-account-t.html
143,https://Technology/siBosizVdRc2rhC5XxDwSO/New-WhatsApp-stickers-update-allows-you-to-create-your-own-s.html?facet=amp,11,8,8,0,technology/siBosizVdRc2rhC5XxDwSO/New-WhatsApp-stickers-update-allows-you-to-create-your-own-s.html?facet=amp
144,https://companies/news/new-logo-reflects-spirit-of-integration-says-voda-idea/amp-11599529451763.html,11,11,9,2,https://companies/news/new-logo-reflects-spirit-of-integration-says-voda-idea/amp
145,https://industry/retail/festivals-bring-some-respite-for-apparel-retailers/amp-11605783606044.html,11,11,3,8,https://industry/retail/festivals-bring-some-respite-for-apparel-retailers/amp
146,https://mint-lounge/features/the-bhujia-king-haldiram-s-shiv-kishan-agarwal-11581075822135.html,11,10,5,5,https://mint-lounge/features/the-bhujia-king-haldiram-s-shiv-kishan-agarwal
147,https://money/personal-finance/one-person-company-all-you-need-to-know-1553596329631.html,11,9,8,1,money/personal-finance/one-person-company-all-you-need-to-know-1553596329631.html
148,https://news/india/centre-announces-10-000-cr-boost-for-rural-economy-11605237685076.html,11,5,0,5,https://news/india/centre-announces-10-000-cr-boost-for-rural-economy
149,https://news/india/how-india-s-map-has-evolved-since-1947-1565803882094.html,11,11,7,4,news/india/how-india-s-map-has-evolved-since-1947-1565803882094.html
150,https://news/india/the-only-indian-state-which-never-reported-any-coronavirus-case/amp-11590294253053.html,11,10,8,2,https://news/india/the-only-indian-state-which-never-reported-any-coronavirus-case/amp
151,https://politics/news/bihar-govt-formation-nitish-kumar-named-as-the-next-bihar-chief-minister/amp-11605426836471.html,11,11,5,6,https://politics/news/bihar-govt-formation-nitish-kumar-named-as-the-next-bihar-chief-minister/amp
152,https://Epaper/M/Mumbai/19/11/2020/Page/13,10,10,0,10,epaper/M/Mumbai/19/11/2020/Page/13
153,https://Money/Qw70XItlrXYKKHYvJEk1GN/Old-SBI-debit-card-wont-work-soon-How-to-apply-online-for.html,10,9,9,0,money/Qw70XItlrXYKKHYvJEk1GN/Old-SBI-debit-card-wont-work-soon-How-to-apply-online-for.html
154,https://Politics/QYaohpsFZCqbxR1lrcy4JK/70-years-in-Indian-politics-and-policy.html,10,10,8,2,politics/QYaohpsFZCqbxR1lrcy4JK/70-years-in-Indian-politics-and-policy.html
155,https://companies/news/bigbasket-faces-data-breach-details-of-2-crore-users-put-on-sale-on-dark-web/amp-11604794339735.html,10,10,4,6,https://companies/news/bigbasket-faces-data-breach-details-of-2-crore-users-put-on-sale-on-dark-web/amp
156,https://companies/start-ups/swiggy-eyes-100-mn-customers-using-the-app-over-15-times-a-month-in-10-15-years-11571422800906.html,10,8,4,4,https://companies/start-ups/swiggy-eyes-100-mn-customers-using-the-app-over-15-times-a-month-in-10-15-years
157,https://leisure/dpyd8ophqcqfz6cdnorzji/cdn.knightlab.com/libs/juxtapose/latest/embed/index.html,10,1,0,1,leisure/dpyd8ophqcqfz6cdnorzji/cdn.knightlab.com/libs/juxtapose/latest/embed/index.html
158,https://money/ask-mint-money/an-ancestral-property-becomes-self-acquired-if-it-is-partitioned-11591723196099.html,10,10,4,6,https://money/ask-mint-money/an-ancestral-property-becomes-self-acquired-if-it-is-partitioned
159,https://money/personal-finance/mutual-fund-apps-that-can-help-you-invest-from-home-11588065573073.html,10,10,3,7,https://money/personal-finance/mutual-fund-apps-that-can-help-you-invest-from-home
160,https://news/india/apple-iphone-12-pro-stuck-in-the-middle/amp-11604916604691.html,10,10,6,4,https://news/india/apple-iphone-12-pro-stuck-in-the-middle/amp
161,https://news/india/high-food-prices-at-heart-of-india-s-inflation-problem-11603988429841.html,10,10,2,8,https://news/india/high-food-prices-at-heart-of-india-s-inflation-problem
162,https://news/india/pensioners-can-store-pension-payment-order-ppo-in-digilocker-here-is-how-11598488458595.html,10,7,2,5,https://news/india/pensioners-can-store-pension-payment-order-ppo-in-digilocker-here-is-how
163,https://news/world/china-targets-frozen-food-imports-over-coronavirus-fears-11605676723646.html,10,10,3,7,https://news/world/china-targets-frozen-food-imports-over-coronavirus-fears
164,https://technology/apps/how-to-restore-whatsapp-chats-when-switching-phones-11581505344399.html,10,10,9,1,https://technology/apps/how-to-restore-whatsapp-chats-when-switching-phones
165,https://Companies/bfjyqT9tUhqWajPWKJco6K/Reliance-plans-expanding-worlds-largest-refinery-complex-R.html?facet=amp,9,9,7,2,companies/bfjyqT9tUhqWajPWKJco6K/Reliance-plans-expanding-worlds-largest-refinery-complex-R.html?facet=amp
166,https://Industry/6nzroP3Ef9GSUrjs9LTGHI/How-Scan-and-Pay-is-facilitating-digital-payments.html,9,9,7,2,industry/6nzroP3Ef9GSUrjs9LTGHI/How-Scan-and-Pay-is-facilitating-digital-payments.html
167,https://Money/NN3COx0LbcYDVOZxDdlTvM/Transferring-insurance-of-secondhand-vehicles.html?facet=amp,9,9,7,2,money/NN3COx0LbcYDVOZxDdlTvM/Transferring-insurance-of-secondhand-vehicles.html?facet=amp
168,https://Politics/HOCSnmCWarO4hpYglBsHBP/What-is-the-Swiss-Challenge-Method.html,9,8,4,4,politics/HOCSnmCWarO4hpYglBsHBP/What-is-the-Swiss-Challenge-Method.html
169,https://auto-news/one-electric-to-launch-one-of-the-fastest-electric-bikes-in-india-details-here-11599818433880.html,9,1,1,0,https://auto-news/one-electric-to-launch-one-of-the-fastest-electric-bikes-in-india-details-here
170,https://companies/news/hero-forecasts-rural-revival-boosts-output-11591726684902.html,9,9,8,1,https://companies/news/hero-forecasts-rural-revival-boosts-output
171,https://companies/start-ups/bengaluru-in-world-s-top-30-startup-ecosystem-list-11593129020042.html,9,6,3,3,https://companies/start-ups/bengaluru-in-world-s-top-30-startup-ecosystem-list
172,https://industry/telecom/jio-s-advance-recharge-plans-can-save-you-from-tariff-hike-for-a-year/amp-11575353828317.html,9,9,7,2,https://industry/telecom/jio-s-advance-recharge-plans-can-save-you-from-tariff-hike-for-a-year/amp
173,https://market/stock-market-news/stocks-to-watch-ril-tech-mahindra-yes-bank-itc-bharti-infratel-pfizer-united-spirits/amp-11595902887089.html,9,9,7,2,https://market/stock-market-news/stocks-to-watch-ril-tech-mahindra-yes-bank-itc-bharti-infratel-pfizer-united-spirits/amp
174,https://money/personal-finance/bank-atm-withdrawal-minimum-balance-relaxations-expire-this-month/amp-11593227914794.html,9,9,6,3,https://money/personal-finance/bank-atm-withdrawal-minimum-balance-relaxations-expire-this-month/amp
175,https://money/personal-finance/new-pan-card-applicants-can-download-e-pan-for-free-here-s-how-1565607088602.html,9,8,6,2,money/personal-finance/new-pan-card-applicants-can-download-e-pan-for-free-here-s-how-1565607088602.html
176,https://news/india/11-58-lakh-non-gazetted-indian-railway-employees-to-get-bonus-equivalent-to-78-day-wages-govt/amp-11603358981943.html,9,9,5,4,https://news/india/11-58-lakh-non-gazetted-indian-railway-employees-to-get-bonus-equivalent-to-78-day-wages-govt/amp
177,https://news/india/gender-equality-how-urban-india-views-women-in-society-1554237479421.html,9,8,6,2,news/india/gender-equality-how-urban-india-views-women-in-society-1554237479421.html
178,https://news/india/manmohan-singh-elected-unopposed-to-rajya-sabha/amp-1566216404761.html,9,8,5,3,news/india/manmohan-singh-elected-unopposed-to-rajya-sabha/amp-1566216404761.html
179,https://news/world/-this-isn-t-over-donald-trump-supporters-refuse-to-accept-defeat-11604793763511.html,9,9,9,0,https://news/world/-this-isn-t-over-donald-trump-supporters-refuse-to-accept-defeat
180,https://politics/news/why-amethi-said-bye-bye-to-rahul/amp-1559494887481.html,9,7,5,2,politics/news/why-amethi-said-bye-bye-to-rahul/amp-1559494887481.html
181,https://technology/tech-news/reliance-jio-offer-5-months-of-free-data-with-new-jiofi-device/amp-11597569274393.html,9,9,6,3,https://technology/tech-news/reliance-jio-offer-5-months-of-free-data-with-new-jiofi-device/amp
182,https://Epaper/Delhi/16/11/2020/Page/01: front,8,8,0,8,epaper/Delhi/16/11/2020/Page/01:%20front
183,https://Leisure/pNfD4rrJwCji3JVwtzDmYP/Dignity-to-sex-work.html?facet=amp,8,8,7,1,leisure/pNfD4rrJwCji3JVwtzDmYP/Dignity-to-sex-work.html?facet=amp
184,https://Money/lAoDltWB3BFwQRdz7UhyTK/Investing-in-Gsecs-becomes-simpler-should-you-buy.html?facet=amp,8,4,1,3,money/lAoDltWB3BFwQRdz7UhyTK/Investing-in-Gsecs-becomes-simpler-should-you-buy.html?facet=amp
185,https://Politics/Pyeimf2T6Rl9R8SabSpsmO/Govt-considers-linking-educational-records-to-Aadhaar.html?facet=amp,8,5,4,1,politics/Pyeimf2T6Rl9R8SabSpsmO/Govt-considers-linking-educational-records-to-Aadhaar.html?facet=amp
186,https://Technology/aut4lb3oGkqrc4ZGgDoerO/8-ways-to-spot-fake-news.html?facet=amp,8,6,2,4,technology/aut4lb3oGkqrc4ZGgDoerO/8-ways-to-spot-fake-news.html?facet=amp
187,https://companies/news/flipkart-wholesale-launches-digital-platform-for-kirana-stores-msmes-11599035899128.html,8,3,2,1,https://companies/news/flipkart-wholesale-launches-digital-platform-for-kirana-stores-msmes
188,https://companies/news/sycamore-partners-under-scrutiny-after-pocketing-1-billion-from-staples-deal/amp-1555019614458.html,8,8,8,0,companies/news/sycamore-partners-under-scrutiny-after-pocketing-1-billion-from-staples-deal/amp-1555019614458.html
189,https://education/news/govt-steps-in-to-help-students-tackle-stressgovt-steps-in-to-help-students-tackl-11595383845821.html,8,6,3,3,https://education/news/govt-steps-in-to-help-students-tackle-stressgovt-steps-in-to-help-students-tackl
190,https://industry/telecom/pli-for-telecom-sector-to-encourage-indian-global-firms-ravi-shankar-prasad-11605108990257.html,8,6,1,5,https://industry/telecom/pli-for-telecom-sector-to-encourage-indian-global-firms-ravi-shankar-prasad
191,https://market/stock-market-news/markets-are-already-pricing-a-successful-moderna-vaccine-shot/amp-11605280591780.html,8,8,1,7,https://market/stock-market-news/markets-are-already-pricing-a-successful-moderna-vaccine-shot/amp
192,https://money/personal-finance/atal-pension-yojana-gave-11-returns-in-one-year-here-s-what-it-means/amp-11600740775301.html,8,6,4,2,https://money/personal-finance/atal-pension-yojana-gave-11-returns-in-one-year-here-s-what-it-means/amp
193,https://money/personal-finance/new-income-tax-slab-rate-you-might-not-need-a-ca-to-file-income-tax-return-itr-11580797305014.html,8,8,3,5,https://money/personal-finance/new-income-tax-slab-rate-you-might-not-need-a-ca-to-file-income-tax-return-itr
194,https://money/personal-finance/you-can-get-instant-e-pan-here-is-how/amp-11572940474229.html,8,8,4,4,https://money/personal-finance/you-can-get-instant-e-pan-here-is-how/amp
195,https://news/india/bharti-infratel-board-approves-merger-with-indus-towers/amp-11598930434341.html,8,7,3,4,https://news/india/bharti-infratel-board-approves-merger-with-indus-towers/amp
196,https://news/india/how-indira-gandhi-and-atal-bihari-vajpayee-led-india-during-1971-bangladesh-war-1551643929931.html,8,8,4,4,news/india/how-indira-gandhi-and-atal-bihari-vajpayee-led-india-during-1971-bangladesh-war-1551643929931.html
197,https://news/india/mumbai-local-train-woman-travelling-with-fake-id-card-with-qr-code-arrested/amp-11597984903202.html,8,6,3,3,https://news/india/mumbai-local-train-woman-travelling-with-fake-id-card-with-qr-code-arrested/amp
198,https://news/india/vaishno-devi-devotees-coming-to-shrine-will-require-covid-19-negative-test-report-11598243662153.html,8,8,6,2,https://news/india/vaishno-devi-devotees-coming-to-shrine-will-require-covid-19-negative-test-report
199,https://opinion/online-views/india-should-use-this-economic-crisis-to-implement-reforms-3-0-11603728986754.html,8,8,0,8,https://opinion/online-views/india-should-use-this-economic-crisis-to-implement-reforms-3-0
200,https://technology/tech-news/realme-launches-narzo-20a-with-starting-price-under-rs-8-500-details-here/amp-11600676714309.html,8,3,2,1,https://technology/tech-news/realme-launches-narzo-20a-with-starting-price-under-rs-8-500-details-here/amp
201,https://Companies/boSuroFjWnoZq4yvly0itO/Can-CSR-funds-make-a-difference-in-healthcare.html,7,5,1,4,companies/boSuroFjWnoZq4yvly0itO/Can-CSR-funds-make-a-difference-in-healthcare.html
202,https://Epaper/M/Delhi/18/11/2020/Page/09,7,5,0,5,epaper/M/Delhi/18/11/2020/Page/09
203,https://Leisure/QoFEZJPUQLRMuobLjPNrZJ/Four-musical-and-literary-influences-on-Bob-Dylan.html,7,7,7,0,leisure/QoFEZJPUQLRMuobLjPNrZJ/Four-musical-and-literary-influences-on-Bob-Dylan.html
204,https://Money/LYOU20kMXkgqa0FEbVFpaP/Who-can-claim-tax-benefit-on-interest-paid-on-education-loan.html?facet=amp,7,4,2,2,money/LYOU20kMXkgqa0FEbVFpaP/Who-can-claim-tax-benefit-on-interest-paid-on-education-loan.html?facet=amp
205,https://Money/vGwO6ejDP4PKIPTAEP9CLP/Four-ways-to-check-whether-property-is-legal.html,7,7,2,5,money/vGwO6ejDP4PKIPTAEP9CLP/Four-ways-to-check-whether-property-is-legal.html
206,https://Politics/JLW1D4srZARBha43GslReK/Ask-Mint--No-borders-here-GNP-is-income-earned-by-a-countr.html?facet=amp,7,2,2,0,politics/JLW1D4srZARBha43GslReK/Ask-Mint--No-borders-here-GNP-is-income-earned-by-a-countr.html?facet=amp
207,https://Sports/0te0KpWOQdbvxpfTjiPi0N/Business-of-tennis-The-expensive-journey-to-Grand-Slam-pare.html,7,7,7,0,sports/0te0KpWOQdbvxpfTjiPi0N/Business-of-tennis-The-expensive-journey-to-Grand-Slam-pare.html
208,https://companies/company-results/reliance-jio-net-profit-jumps-183-to-rs-2-520-crore-in-q1/amp-11596102630222.html,7,7,2,5,https://companies/company-results/reliance-jio-net-profit-jumps-183-to-rs-2-520-crore-in-q1/amp
209,https://companies/news/indigo-offers-flight-tickets-from-rs-999-in-sale-11582174822347.html,7,3,3,0,https://companies/news/indigo-offers-flight-tickets-from-rs-999-in-sale
210,https://companies/news/tcs-in-talks-to-buy-deutsche-bank-s-technology-unit/amp-11603343464817.html,7,7,2,5,https://companies/news/tcs-in-talks-to-buy-deutsche-bank-s-technology-unit/amp
211,https://companies/start-ups/the-unraveling-of-shopclues-from-unicorn-to-also-ran-11572756549494.html,7,5,1,4,https://companies/start-ups/the-unraveling-of-shopclues-from-unicorn-to-also-ran
212,https://industry/banking/mpokket-to-disburse-instant-loans-of-rs-1-200-cr-this-fiscal-11600691162210.html,7,7,1,6,https://industry/banking/mpokket-to-disburse-instant-loans-of-rs-1-200-cr-this-fiscal
213,https://industry/manufacturing/quadria-capital-invests-70-million-in-new-delhi-based-akums-drugs/amp-11575824503509.html,7,6,4,2,https://industry/manufacturing/quadria-capital-invests-70-million-in-new-delhi-based-akums-drugs/amp
214,https://market/ipo/uti-amc-shares-list-at-a-discount-as-compared-to-issue-price-11602475808347.html,7,6,1,5,https://market/ipo/uti-amc-shares-list-at-a-discount-as-compared-to-issue-price
215,https://market/stock-market-news/stocks-to-watch-ril-lakshmi-vilas-bank-mindtree-dr-reddy-s-sun-pharma-ceat-11601259499312.html,7,3,0,3,https://market/stock-market-news/stocks-to-watch-ril-lakshmi-vilas-bank-mindtree-dr-reddy-s-sun-pharma-ceat
216,https://money/personal-finance/bank-fixed-deposit-fd-rates-of-9-9-5-senior-citizens-check-rates-here/amp-11577427612381.html,7,6,3,3,https://money/personal-finance/bank-fixed-deposit-fd-rates-of-9-9-5-senior-citizens-check-rates-here/amp
217,https://money/personal-finance/is-your-sbi-home-personal-loan-eligible-for-restructuring-check-out-here/amp-11600684050733.html,7,6,4,2,https://money/personal-finance/is-your-sbi-home-personal-loan-eligible-for-restructuring-check-out-here/amp
218,https://money/personal-finance/there-is-no-provision-to-cancel-or-surrender-aadhaar-even-after-death/amp-1551006578655.html,7,7,5,2,money/personal-finance/there-is-no-provision-to-cancel-or-surrender-aadhaar-even-after-death/amp-1551006578655.html
219,https://news/india/4-states-1-union-territory-remain-coronavirus-free-11589261106031.html,7,7,6,1,https://news/india/4-states-1-union-territory-remain-coronavirus-free
220,https://news/india/delhi-govt-has-no-money-to-pay-salaries-writes-to-centre-for-rs5-000-crore-11590917422950.html,7,5,1,4,https://news/india/delhi-govt-has-no-money-to-pay-salaries-writes-to-centre-for-rs5-000-crore
221,https://news/india/india-s-exporters-are-on-the-edge/amp-11598795755885.html,7,7,5,2,https://news/india/india-s-exporters-are-on-the-edge/amp
222,https://news/india/narendra-modi-live-nep-2020-is-foundation-of-new-india-of-21st-century-11596777124250.html,7,7,5,2,https://news/india/narendra-modi-live-nep-2020-is-foundation-of-new-india-of-21st-century
223,https://news/india/sc-stays-hc-order-asking-spicejet-to-deposit-243-crore-in-kalanithi-maran-case/amp-11604649208197.html,7,6,3,3,https://news/india/sc-stays-hc-order-asking-spicejet-to-deposit-243-crore-in-kalanithi-maran-case/amp
224,https://news/india/why-antitrust-is-a-jumbo-indian-problem-11596375452543.html,7,4,1,3,https://news/india/why-antitrust-is-a-jumbo-indian-problem
225,https://opinion/columns/should-emerging-markets-go-for-modern-monetary-theory-11603984870843.html,7,3,2,1,https://opinion/columns/should-emerging-markets-go-for-modern-monetary-theory
226,https://politics/policy/the-shrinking-of-india-s-middle-class-11572505342371.html,7,6,3,3,https://politics/policy/the-shrinking-of-india-s-middle-class
227,https://technology/tech-news/sony-microsoft-consoles-struggle-with-thin-launch-day-stock/amp-11605759717588.html,7,7,2,5,https://technology/tech-news/sony-microsoft-consoles-struggle-with-thin-launch-day-stock/amp
228,https://Companies/TI4EFOpnwPeEnstYZosTvI/The-best-film-on-leadership-I-have-seen-Guru.html,6,3,3,0,companies/TI4EFOpnwPeEnstYZosTvI/The-best-film-on-leadership-I-have-seen-Guru.html
229,https://Epaper/Delhi/17/11/2020/Page/08: top stories,6,6,0,6,epaper/Delhi/17/11/2020/Page/08:%20top%20stories
230,https://Industry/hjIp8VGEZvn2JGryfI5OzJ/Same-DeutzFahr-introduces-Lamborghini-tractor-in-India.html?facet=amp,6,6,5,1,industry/hjIp8VGEZvn2JGryfI5OzJ/Same-DeutzFahr-introduces-Lamborghini-tractor-in-India.html?facet=amp
231,https://Leisure/o6NwRwGL92aWy7uWRDaATL/Game-review-Dream-League-Soccer-2017-cant-match-FIFA.html,6,4,4,0,leisure/o6NwRwGL92aWy7uWRDaATL/Game-review-Dream-League-Soccer-2017-cant-match-FIFA.html
232,https://Money/KVpRnmlznCLrqssriFnZdL/You-cannot-draw-on-provident-fund-to-pay-a-personal-loan.html,6,5,2,3,money/KVpRnmlznCLrqssriFnZdL/You-cannot-draw-on-provident-fund-to-pay-a-personal-loan.html
233,https://Multimedia/Yl0Blp74olwEbV8NjPyYAJ/Sarojini-Nagar-market-hasnt-shut-down--Video.html?facet=amp,6,6,4,2,multimedia/Yl0Blp74olwEbV8NjPyYAJ/Sarojini-Nagar-market-hasnt-shut-down--Video.html?facet=amp
234,https://Politics/5VFO4fMHf1d96VFXrVKfPM/Five-longest-speeches-in-political-history.html,6,5,4,1,politics/5VFO4fMHf1d96VFXrVKfPM/Five-longest-speeches-in-political-history.html
235,https://Search/Link/Author/Rahul-Jacob,6,6,0,6,search/Link/Author/Rahul-Jacob
236,https://auto-news/156-km-on-single-charge-revolt-rv400-electric-bike-unveiled-in-india/amp-1560853347785.html,6,6,6,0,auto-news/156-km-on-single-charge-revolt-rv400-electric-bike-unveiled-in-india/amp-1560853347785.html
237,https://companies/company-results/hal-s-q2-net-profit-decreases-marginally-to-rs-615-cr/amp-11605262481364.html,6,6,2,4,https://companies/company-results/hal-s-q2-net-profit-decreases-marginally-to-rs-615-cr/amp
238,https://companies/news/digital-platforms-shine-spotlight-on-small-medium-biz-11605231496404.html,6,6,1,5,https://companies/news/digital-platforms-shine-spotlight-on-small-medium-biz
239,https://companies/news/meteor-350-aimed-at-pulling-customers-from-other-brands-sid-lal-11605193221741.html,6,5,0,5,https://companies/news/meteor-350-aimed-at-pulling-customers-from-other-brands-sid-lal
240,https://companies/news/suzuki-jv-to-invest-3-715-crore-in-second-phase-of-battery-venture-11577900471545.html,6,6,3,3,https://companies/news/suzuki-jv-to-invest-3-715-crore-in-second-phase-of-battery-venture
241,https://companies/people/we-never-told-the-coronil-can-cure-or-control-corona-patanjali-ceo-acharya-balkrishna/amp-11593514785834.html,6,6,2,4,https://companies/people/we-never-told-the-coronil-can-cure-or-control-corona-patanjali-ceo-acharya-balkrishna/amp
242,https://industry/banking/15-foreign-banks-keen-to-open-branch-in-india-11574172433907.html,6,6,3,3,https://industry/banking/15-foreign-banks-keen-to-open-branch-in-india
243,https://industry/infrastructure/prestige-group-agrees-to-sell-certain-office-retail-assets-and-2-hotels-to-blackstone-for-rs-12k-cr-11602982257982.html,6,6,3,3,https://industry/infrastructure/prestige-group-agrees-to-sell-certain-office-retail-assets-and-2-hotels-to-blackstone-for-rs-12k-cr
244,https://insurance/news/will-covid-19-vaccine-be-covered-under-your-existing-health-insurance-policy-11598798661293.html,6,6,3,3,https://insurance/news/will-covid-19-vaccine-be-covered-under-your-existing-health-insurance-policy
245,https://market/stock-market-news/govt-s-divestment-efforts-may-get-a-15-000-cr-boost-11601865784809.html,6,6,1,5,https://market/stock-market-news/govt-s-divestment-efforts-may-get-a-15-000-cr-boost
246,https://mint-lounge/features/the-big-himalayan-earthquake-is-coming-11594365372475.html,6,6,4,2,https://mint-lounge/features/the-big-himalayan-earthquake-is-coming
247,https://money/personal-finance/contribution-to-eps-is-not-payable-from-employee-s-pf-share/amp-11595526174923.html,6,5,2,3,https://money/personal-finance/contribution-to-eps-is-not-payable-from-employee-s-pf-share/amp
248,https://money/personal-finance/income-tax-officers-suggest-40-tax-on-super-rich-covid-relief-cess-11587894341797.html,6,5,2,3,https://money/personal-finance/income-tax-officers-suggest-40-tax-on-super-rich-covid-relief-cess
249,https://money/personal-finance/sbi-revises-fixed-deposit-fd-interest-rates-check-latest-rates-here-11570599090824.html,6,3,1,2,https://money/personal-finance/sbi-revises-fixed-deposit-fd-interest-rates-check-latest-rates-here
250,https://news/delhi-govt-provided-over-60-000-oximeters-to-covid-19-patients-data/amp-11601217980428.html,6,5,2,3,https://news/delhi-govt-provided-over-60-000-oximeters-to-covid-19-patients-data/amp
251,https://news/india/bengaluru-metro-train-network-to-be-extended-check-new-routes/amp-11573174168643.html,6,5,2,3,https://news/india/bengaluru-metro-train-network-to-be-extended-check-new-routes/amp
252,https://news/india/defence-ministry-withdraws-order-on-income-tax-deduction-from-disability-pension-11583247710845.html,6,6,2,4,https://news/india/defence-ministry-withdraws-order-on-income-tax-deduction-from-disability-pension
253,https://news/india/govt-relaxes-visa-rules-oci-and-pio-card-holders-can-visit-india-11603352892070.html,6,4,1,3,https://news/india/govt-relaxes-visa-rules-oci-and-pio-card-holders-can-visit-india
254,https://news/india/india-to-overtake-japan-to-become-3rd-largest-economy-in-2025-1562937733376.html,6,6,5,1,news/india/india-to-overtake-japan-to-become-3rd-largest-economy-in-2025-1562937733376.html
255,https://news/india/mumbai-lockdown-for-next-2-weeks-offices-uber-liquor-shops-what-s-allowed-and-what-s-not-11588397550389.html,6,6,6,0,https://news/india/mumbai-lockdown-for-next-2-weeks-offices-uber-liquor-shops-what-s-allowed-and-what-s-not
256,https://news/india/s-n-shrivastava-appointed-delhi-police-commissioner-replaces-amulya-patnaik/amp-11582868863688.html,6,5,4,1,https://news/india/s-n-shrivastava-appointed-delhi-police-commissioner-replaces-amulya-patnaik/amp
257,https://news/india/us-raises-concerns-over-rbi-s-move-to-create-credit-registry-1557338438758.html,6,4,2,2,news/india/us-raises-concerns-over-rbi-s-move-to-create-credit-registry-1557338438758.html
258,https://news/world/us-fda-authorizes-first-covid-19-test-for-self-testing-at-home-11605668508702.html,6,6,1,5,https://news/world/us-fda-authorizes-first-covid-19-test-for-self-testing-at-home
259,https://opinion/online-views/what-india-should-do-as-china-s-economy-shifts/amp-11604244556543.html,6,6,4,2,https://opinion/online-views/what-india-should-do-as-china-s-economy-shifts/amp
260,https://sports/cricket-news/what-are-bio-secure-bubbles-the-new-normal-for-cricket-tournaments/amp-11600321505377.html,6,6,3,3,https://sports/cricket-news/what-are-bio-secure-bubbles-the-new-normal-for-cricket-tournaments/amp
261,https://technology/tech-news/why-applesearch-engine-is-not-such-a-bad-idea-11603952742157.html,6,5,5,0,https://technology/tech-news/why-applesearch-engine-is-not-such-a-bad-idea
262,https://Companies/AOaBqucfWMLrAe9IGAf4sO/Mickey-Mouse-turns-90-and-Walt-Disney-is-happy.html,5,4,4,0,companies/AOaBqucfWMLrAe9IGAf4sO/Mickey-Mouse-turns-90-and-Walt-Disney-is-happy.html
263,https://Companies/hXgSfaFnWEOtGQLoWY2qzI/Hexaware-appoints-R-Srikrishna-as-new-CEO.html,5,4,3,1,companies/hXgSfaFnWEOtGQLoWY2qzI/Hexaware-appoints-R-Srikrishna-as-new-CEO.html
264,https://Consumer/vj5e3v3uGyQR9KRwcvNBvN/Millennials-to-redefine-Indias-consumption-story-report.html,5,4,1,3,consumer/vj5e3v3uGyQR9KRwcvNBvN/Millennials-to-redefine-Indias-consumption-story-report.html
265,https://Home/MShareImage?Pictureid=19118b8330fb,5,5,0,5,home/MShareImage?Pictureid=19118b8330fb
266,https://Leisure/69w1UhYcf1DqvqoSsFTdUJ/My-sweet-lords.html?facet=amp,5,1,1,0,leisure/69w1UhYcf1DqvqoSsFTdUJ/My-sweet-lords.html?facet=amp
267,https://Leisure/jOVhUqp249xSuv0iGqaNnM/Book-Review-A-Strangeness-In-My-Mind.html,5,1,1,0,leisure/jOVhUqp249xSuv0iGqaNnM/Book-Review-A-Strangeness-In-My-Mind.html
268,https://Money/78YOwFK3k4HVt32iCqx5QO/Monthly-family-pension-is-exempt-under-certain-circumstances.html?facet=amp,5,3,1,2,money/78YOwFK3k4HVt32iCqx5QO/Monthly-family-pension-is-exempt-under-certain-circumstances.html?facet=amp
269,https://Money/XsHV89XcIUpPv1WhQyV0yI/Did-you-know-to-nominate-or-have-a-joint-account-holder.html?facet=amp,5,5,3,2,money/XsHV89XcIUpPv1WhQyV0yI/Did-you-know-to-nominate-or-have-a-joint-account-holder.html?facet=amp
270,https://Money/odNRZnkXYHmdHK3GrwBOcM/Costs-related-to-car-used-for-business-can-be-reduced-from-y.html?facet=amp,5,5,3,2,money/odNRZnkXYHmdHK3GrwBOcM/Costs-related-to-car-used-for-business-can-be-reduced-from-y.html?facet=amp
271,https://Opinion/K7BtzvPYmyO0KlDn21iixH/How-to-break-the-back-of-Indias-Leftwing-ecosystem.html,5,5,2,3,opinion/K7BtzvPYmyO0KlDn21iixH/How-to-break-the-back-of-Indias-Leftwing-ecosystem.html
272,https://Politics/BcjnsPIoTfZZs6fJbjtB8I/Delhi-Metro-to-add-six-new-routes-Check-them-out-here.html?facet=amp,5,5,4,1,politics/BcjnsPIoTfZZs6fJbjtB8I/Delhi-Metro-to-add-six-new-routes-Check-them-out-here.html?facet=amp
273,https://Politics/gx6Uh1sl0uEgCY1tGHUuPI/Bank-account-details-not-in-RTI-ambit.html?facet=amp,5,5,2,3,politics/gx6Uh1sl0uEgCY1tGHUuPI/Bank-account-details-not-in-RTI-ambit.html?facet=amp
274,https://Search/Link/Author/Shubham-Ladha,5,4,1,3,search/Link/Author/Shubham-Ladha
275,https://Sundayapp/4V5GYZgqJJioqFKXSfYFJI/2003-World-Cup-final-If-only-India-had-chosen-to-bat-first.html?facet=amp,5,5,4,1,sundayapp/4V5GYZgqJJioqFKXSfYFJI/2003-World-Cup-final-If-only-India-had-chosen-to-bat-first.html?facet=amp
276,https://brand-post/invest-in-companies-before-they-launch-their-ipos/amp-11587472378958.html,5,4,1,3,https://brand-post/invest-in-companies-before-they-launch-their-ipos/amp
277,https://companies/cost-cutting-bears-fruit-for-auto-firms/amp-11605233837398.html,5,5,0,5,https://companies/cost-cutting-bears-fruit-for-auto-firms/amp
278,https://companies/news/coffee-day-appoints-interim-chairman-plans-to-sell-assets-to-reduce-debt-1564596544881.html,5,2,1,1,companies/news/coffee-day-appoints-interim-chairman-plans-to-sell-assets-to-reduce-debt-1564596544881.html
279,https://companies/news/half-hour-of-netflix-leads-to-emissions-of-1-6kg-of-co2-equivalent-climate-experts-11572240109579.html,5,4,4,0,https://companies/news/half-hour-of-netflix-leads-to-emissions-of-1-6kg-of-co2-equivalent-climate-experts
280,https://companies/news/nestl-launches-new-maggi-recipes-to-beat-lockdown-blues-11587375622640.html,5,4,2,2,https://companies/news/nestl-launches-new-maggi-recipes-to-beat-lockdown-blues
281,https://companies/news/sony-viacom18-merger-to-help-sonyliv-voot-increase-revenue-by-30-11597126694705.html,5,4,2,2,https://companies/news/sony-viacom18-merger-to-help-sonyliv-voot-increase-revenue-by-30
282,https://companies/people/-cognizant-s-refined-strategic-focus-on-digital-imperatives-is-paying-dividends-11581000851835.html,5,4,3,1,https://companies/people/-cognizant-s-refined-strategic-focus-on-digital-imperatives-is-paying-dividends
283,https://companies/start-ups/medikabazaar-plans-drone-delivery-pilots-for-critical-medical-supplies-11594128223244.html,5,3,2,1,https://companies/start-ups/medikabazaar-plans-drone-delivery-pilots-for-critical-medical-supplies
284,https://elections/lok-sabha-elections/west-bengal-exit-polls-2019-live-updates-1558259545537.html,5,2,1,1,elections/lok-sabha-elections/west-bengal-exit-polls-2019-live-updates-1558259545537.html
285,https://industry/banking/rbi-relaxes-leverage-ratio-for-banks-to-boost-their-lending-capacity/amp-1561744817188.html,5,4,2,2,industry/banking/rbi-relaxes-leverage-ratio-for-banks-to-boost-their-lending-capacity/amp-1561744817188.html
286,https://industry/manufacturing/large-steel-players-stage-recovery-in-august-while-msmes-are-in-distress-11600274749062.html,5,2,1,1,https://industry/manufacturing/large-steel-players-stage-recovery-in-august-while-msmes-are-in-distress
287,https://insurance/news/a-perfect-gift-for-your-family-this-festive-season/amp-11605313454292.html,5,5,2,3,https://insurance/news/a-perfect-gift-for-your-family-this-festive-season/amp
288,https://market/mark-to-market/comatose-lakshmi-vilas-bank-needs-a-quick-rbi-prescription-11601286464982.html,5,2,1,1,https://market/mark-to-market/comatose-lakshmi-vilas-bank-needs-a-quick-rbi-prescription
289,https://market/stock-market-news/morgan-stanley-s-ridham-desai-says-indian-markets-attractive-likes-mid-caps/amp-11602834157399.html,5,5,2,3,https://market/stock-market-news/morgan-stanley-s-ridham-desai-says-indian-markets-attractive-likes-mid-caps/amp
290,https://mint-lounge/features/covid-19-in-prison-is-india-doing-enough-11594096672458.html,5,3,2,1,https://mint-lounge/features/covid-19-in-prison-is-india-doing-enough
291,https://money/ask-mint-money/during-the-limitation-period-legal-heirs-can-object-to-asset-transfer-1568127638170.html,5,3,1,2,money/ask-mint-money/during-the-limitation-period-legal-heirs-can-object-to-asset-transfer-1568127638170.html
292,https://money/personal-finance/decoding-income-tax-exemptions-1558004382727.html,5,5,5,0,money/personal-finance/decoding-income-tax-exemptions-1558004382727.html
293,https://money/personal-finance/india-post-payments-bank-ippb-rolls-out-of-aadhaar-enabled-payment-services-aeps-10-things-to-know/amp-1568024793422.html,5,4,0,4,money/personal-finance/india-post-payments-bank-ippb-rolls-out-of-aadhaar-enabled-payment-services-aeps-10-things-to-know/amp-1568024793422.html
294,https://money/personal-finance/pan-aadhaar-linking-deadline-september-30-failure-name-mismatch/amp-1569493056484.html,5,3,1,2,money/personal-finance/pan-aadhaar-linking-deadline-september-30-failure-name-mismatch/amp-1569493056484.html
295,https://money/personal-finance/things-customers-can-check-to-find-out-if-a-bank-is-in-trouble-11583749851036.html,5,5,3,2,https://money/personal-finance/things-customers-can-check-to-find-out-if-a-bank-is-in-trouble
296,https://mutual-fund/mf-news/neelesh-surana-of-mirae-asset-shares-covid-proof-mutual-fund-investment-strategy/amp-11599612463892.html,5,4,1,3,https://mutual-fund/mf-news/neelesh-surana-of-mirae-asset-shares-covid-proof-mutual-fund-investment-strategy/amp
297,https://news/india/adani-group-set-to-develop-sri-lanka-s-east-container-terminal-in-colombo-port-11604395943597.html,5,3,1,2,https://news/india/adani-group-set-to-develop-sri-lanka-s-east-container-terminal-in-colombo-port
298,https://news/india/coronavirus-cases-rise-the-most-in-west-bengal-ahead-of-durga-puja-11603350262444.html,5,5,2,3,https://news/india/coronavirus-cases-rise-the-most-in-west-bengal-ahead-of-durga-puja
299,https://news/india/digital-ad-spends-to-cross-50-000-crore-mark-by-2025-report/amp-11579781295911.html,5,3,2,1,https://news/india/digital-ad-spends-to-cross-50-000-crore-mark-by-2025-report/amp
300,https://news/india/haryana-issues-new-guidelines-for-home-isolation-care-of-covid-19-patients/amp-11600487182443.html,5,5,1,4,https://news/india/haryana-issues-new-guidelines-for-home-isolation-care-of-covid-19-patients/amp
301,https://news/india/india-s-vaccine-production-capacity-to-help-humanity-in-fight-against-covid-pm-11601129085566.html,5,5,2,3,https://news/india/india-s-vaccine-production-capacity-to-help-humanity-in-fight-against-covid-pm
302,https://news/india/kerala-to-provide-free-high-speed-internet-connections-to-the-poor-soon/amp-11590827328639.html,5,5,3,2,https://news/india/kerala-to-provide-free-high-speed-internet-connections-to-the-poor-soon/amp
303,https://news/india/npci-launches-international-arm-for-adoption-of-upi-rupay-in-other-countries-11597846171558.html,5,4,1,3,https://news/india/npci-launches-international-arm-for-adoption-of-upi-rupay-in-other-countries
304,https://news/india/registration-of-construction-worker-through-door-step-delivery-in-delhi-manish-sisodia/amp-11605773319764.html?__twitter_impression=true,5,4,2,2,https://news/india/registration-of-construction-worker-through-door-step-delivery-in-delhi-manish-sisodia/amp-11605773319764.html?__twitter_impression=true
305,https://news/india/the-gloomy-reality-of-gulf-returnees-11597673455177.html,5,5,4,1,https://news/india/the-gloomy-reality-of-gulf-returnees
306,https://news/india/zydus-cadila-s-covid-19-therapy-pegihep-completes-phase-ii-trial-11605160568754.html,5,5,3,2,https://news/india/zydus-cadila-s-covid-19-therapy-pegihep-completes-phase-ii-trial
307,https://news/world/uk-study-finds-cellular-immunity-in-non-hospitalised-covid-cases-at-6-months-11604383001192.html,5,4,0,4,https://news/world/uk-study-finds-cellular-immunity-in-non-hospitalised-covid-cases-at-6-months
308,https://opinion/online-views/india-needs-an-open-capital-account-by-2025/amp-11599303164180.html,5,3,1,2,https://opinion/online-views/india-needs-an-open-capital-account-by-2025/amp
309,https://politics/policy/nhb-tightens-norms-on-hfcs-leverage-and-capital-adequacy-ratios-1561051669685.html,5,4,1,3,politics/policy/nhb-tightens-norms-on-hfcs-leverage-and-capital-adequacy-ratios-1561051669685.html
310,https://technology/gadgets/oneplus-8t-with-120-hz-refresh-rate-launched-price-starts-at-rs-42-999-details-here-11602684298722.html,5,4,2,2,https://technology/gadgets/oneplus-8t-with-120-hz-refresh-rate-launched-price-starts-at-rs-42-999-details-here
311,https://technology/tech-news/skullcandy-offers-up-to-65-discount-on-earbuds-headphones/amp-11603992974214.html,5,4,3,1,https://technology/tech-news/skullcandy-offers-up-to-65-discount-on-earbuds-headphones/amp
312,https://topic/vodafone-idea,5,4,1,3,topic/vodafone-idea
313,https://Companies/CqflpmmPbkpLrx9HathB3H/Ratan-Tata-to-set-up-venture-capital-fund.html?facet=amp,4,4,2,2,companies/CqflpmmPbkpLrx9HathB3H/Ratan-Tata-to-set-up-venture-capital-fund.html?facet=amp
314,https://Companies/W1KcASuM6q2liXL3ALmJRJ/Bajaj-Group-plans-for-Gen-Next-with-a-family-settlement.html,4,3,0,3,companies/W1KcASuM6q2liXL3ALmJRJ/Bajaj-Group-plans-for-Gen-Next-with-a-family-settlement.html
315,https://Companies/z4Q2wkDfcUNq4uPsdyxAPP/PG-plans-to-eliminate-100-brands-to-focus-on-top-performers.html,4,1,0,1,companies/z4Q2wkDfcUNq4uPsdyxAPP/PG-plans-to-eliminate-100-brands-to-focus-on-top-performers.html
316,https://Epaper/M/Delhi/17/11/2020/Page/09,4,2,0,2,epaper/M/Delhi/17/11/2020/Page/09
317,https://Home/MShareImage?Pictureid=19111236aa1d,4,4,0,4,home/MShareImage?Pictureid=19111236aa1d
318,https://Industry/NNSp24iiLKefdhSPrSM6kO/Cosmetics-firms-stock-products-on-pharmacy-shelves-to-push-s.html?facet=amp,4,4,4,0,industry/NNSp24iiLKefdhSPrSM6kO/Cosmetics-firms-stock-products-on-pharmacy-shelves-to-push-s.html?facet=amp
319,https://Leisure/51qRFg00sGfh2kIVvTZRWI/The-challenges-of-making-public-policy.html?facet=amp,4,4,3,1,leisure/51qRFg00sGfh2kIVvTZRWI/The-challenges-of-making-public-policy.html?facet=amp
320,https://Leisure/QdWbf4DI5TntzyaSnMyhXM/A-trip-to-the-Sundarbans.html,4,4,2,2,leisure/QdWbf4DI5TntzyaSnMyhXM/A-trip-to-the-Sundarbans.html
321,https://Leisure/gfbTsQEY7G32nvh2DMx02H/The-slumdog-story.html,4,3,2,1,leisure/gfbTsQEY7G32nvh2DMx02H/The-slumdog-story.html
322,https://Leisure/zF4kWDw94cn6byDzjq6aQO/Game-review-Assassins-Creed-Identity.html,4,4,4,0,leisure/zF4kWDw94cn6byDzjq6aQO/Game-review-Assassins-Creed-Identity.html
323,https://Money/BnwoF7nQJfFA4llR9ktkFL/What-you-need-to-know-before-taking-an-education-loan.html?facet=amp,4,4,1,3,money/BnwoF7nQJfFA4llR9ktkFL/What-you-need-to-know-before-taking-an-education-loan.html?facet=amp
324,https://Money/RT7ECufnnRzCxDjWU34zMP/Are-celebs-responsible-for-the-investments-they-endorse.html?facet=amp,4,3,2,1,money/RT7ECufnnRzCxDjWU34zMP/Are-celebs-responsible-for-the-investments-they-endorse.html?facet=amp
325,https://Money/ihlm1NpnA3yZpbBHUnNxHP/Shortterm-capital-gains-tax-applies-if-you-sell-the-shares.html?facet=amp,4,3,1,2,money/ihlm1NpnA3yZpbBHUnNxHP/Shortterm-capital-gains-tax-applies-if-you-sell-the-shares.html?facet=amp
326,https://Multimedia/Nl2thJvsNbktoiHCIpPh8J/Chacha-Nehru-and-his-furry-friends.html?facet=amp,4,3,0,3,multimedia/Nl2thJvsNbktoiHCIpPh8J/Chacha-Nehru-and-his-furry-friends.html?facet=amp
327,https://Opinion/M2I4UZdoN9ia2KJMWfP4RK/Confucius-on-trading-with-China.html,4,3,3,0,opinion/M2I4UZdoN9ia2KJMWfP4RK/Confucius-on-trading-with-China.html
328,https://Opinion/mF6QseomYZNcvZuUhyNDKI/Biofuels-an-opportunity-for-India.html,4,3,3,0,opinion/mF6QseomYZNcvZuUhyNDKI/Biofuels-an-opportunity-for-India.html
329,https://Politics/5HU9KriaUIbYUaPdvdvtsO/www.thinglink.com/card/www.thinglink.com/card/www.thinglink.com/card/www.thinglink.com/card/www.thinglink.com/card/611491258145177600,4,3,0,3,politics/5HU9KriaUIbYUaPdvdvtsO/www.thinglink.com/card/www.thinglink.com/card/www.thinglink.com/card/www.thinglink.com/card/www.thinglink.com/card/611491258145177600
330,https://Politics/5HU9KriaUIbYUaPdvdvtsO/www.thinglink.com/card/www.thinglink.com/card/www.thinglink.com/card/www.thinglink.com/card/www.thinglink.com/card/www.thinglink.com/card/www.thinglink.com/card/www.thinglink.com/card/www.thinglink.com/card/www.thinglink.com/card/www.thinglink.com/card/www.thinglink.com/card/www.thinglink.com/card/www.thinglink.com/card/www.thinglink.com/card/www.thinglink.com/card/www.thinglink.com/card/www.thinglink.com/card/www.thinglink.com/card/www.thinglink.com/card/www.thinglink.com/card/www.thinglink.com/card/www.thinglink.com/card/www.thinglink.com/card/www.thinglink.com/card/www.thinglink.com/card/www.thinglink.com/card/www.thinglink.com/card/www.thinglink.com/card/www.thinglink.com/card/www.thinglink.com/card/www.thinglink.com/card/www.thinglink.com/card/www.thinglink.com/card/www.thinglink.com/card/www.thinglink.com/card/www.thinglink.com/card/www.thinglink.com/card/www.thinglink.com/card/www.thinglink.com/card/www.thinglink.com/card/www.thinglink.com/card/www.thinglink.com/card/www.thinglink.com/card/www.thinglink.com/card/www.thinglink.com/card/www.thinglink.com/card/www.thinglink.com/card/www.thinglink.com/card/www.thinglink.com/card/www.thinglink.com/card/www.thinglink.com/card/www.thinglink.com/card/www.thinglink.com/card/www.thinglink.com/card/www.thinglink.com/card/www.thinglink.com/card/611491258145177600,4,3,0,3,politics/5HU9KriaUIbYUaPdvdvtsO/www.thinglink.com/card/www.thinglink.com/card/www.thinglink.com/card/www.thinglink.com/card/www.thinglink.com/card/www.thinglink.com/card/www.thinglink.com/card/www.thinglink.com/card/www.thinglink.com/card/www.thinglink.com/card/www.thinglink.com/card/www.thinglink.com/card/www.thinglink.com/card/www.thinglink.com/card/www.thinglink.com/card/www.thinglink.com/card/www.thinglink.com/card/www.thinglink.com/card/www.thinglink.com/card/www.thinglink.com/card/www.thinglink.com/card/www.thinglink.com/card/www.thinglink.com/card/www.thinglink.com/card/www.thinglink.com/card/www.thinglink.com/card/www.thinglink.com/card/www.thinglink.com/card/www.thinglink.com/card/www.thinglink.com/card/www.thinglink.com/card/www.thinglink.com/card/www.thinglink.com/card/www.thinglink.com/card/www.thinglink.com/card/www.thinglink.com/card/www.thinglink.com/card/www.thinglink.com/card/www.thinglink.com/card/www.thinglink.com/card/www.thinglink.com/card/www.thinglink.com/card/www.thinglink.com/card/www.thinglink.com/card/www.thinglink.com/card/www.thinglink.com/card/www.thinglink.com/card/www.thinglink.com/card/www.thinglink.com/card/www.thinglink.com/card/www.thinglink.com/card/www.thinglink.com/card/www.thinglink.com/card/www.thinglink.com/card/www.thinglink.com/card/www.thinglink.com/card/www.thinglink.com/card/611491258145177600
331,https://Politics/HkujNa0LphyCVSoqFFIEWK/Five-charts-that-explain-the-crisis-in-the-Kerala-economy.html?facet=amp,4,4,2,2,politics/HkujNa0LphyCVSoqFFIEWK/Five-charts-that-explain-the-crisis-in-the-Kerala-economy.html?facet=amp
332,https://Politics/ar1HGDFjvssPzaInLt4ZZK/Why-are-Indian-farmers-taking-to-horticulture.html,4,4,2,2,politics/ar1HGDFjvssPzaInLt4ZZK/Why-are-Indian-farmers-taking-to-horticulture.html
333,https://Politics/uNG9gJVysAolCNjYNW9XlI/What-is-the-Specific-Relief-Act-and-why-does-the-govt-want-t.html?facet=amp,4,4,4,0,politics/uNG9gJVysAolCNjYNW9XlI/What-is-the-Specific-Relief-Act-and-why-does-the-govt-want-t.html?facet=amp
334,https://Search/Link/Keyword/India-Investment,4,4,1,3,search/Link/Keyword/India-Investment
335,https://Search/Link/Keyword/loan-moratorium,4,3,0,3,search/Link/Keyword/loan-moratorium
336,https://Technology/ACHEI1t6mB34c4xM5DiTsN/The-top-five-trends-in-Indias-digital-payment-landscape.html,4,4,3,1,technology/ACHEI1t6mB34c4xM5DiTsN/The-top-five-trends-in-Indias-digital-payment-landscape.html
337,https://auto-news/first-mahindra-thar-2020-delivered-here-s-what-is-special-about-it/amp-11604325840823.html,4,4,4,0,https://auto-news/first-mahindra-thar-2020-delivered-here-s-what-is-special-about-it/amp
338,https://brand-stories/how-does-the-workplace-of-the-future-look-like-11584713699808.html,4,3,0,3,https://brand-stories/how-does-the-workplace-of-the-future-look-like
339,https://companies/news/adani-power-board-approves-rs-3-264-crore-delisting-plan/amp-11592829821565.html,4,4,0,4,https://companies/news/adani-power-board-approves-rs-3-264-crore-delisting-plan/amp
340,https://companies/news/brookfield-gic-buy-reliance-jio-s-telecom-tower-assets-for-rs-25-000-crore-11598932634932.html,4,4,3,1,https://companies/news/brookfield-gic-buy-reliance-jio-s-telecom-tower-assets-for-rs-25-000-crore
341,https://companies/news/dr-reddy-s-gets-dcgi-nod-to-conduct-clinical-trial-for-sputnik-v-vaccine-in-india-11602932255342.html,4,4,1,3,https://companies/news/dr-reddy-s-gets-dcgi-nod-to-conduct-clinical-trial-for-sputnik-v-vaccine-in-india
342,https://companies/news/india-s-skilling-firms-have-entered-the-icu/amp-11601908363753.html,4,4,3,1,https://companies/news/india-s-skilling-firms-have-entered-the-icu/amp
343,https://companies/news/multiplex-operator-inox-leisure-raises-rs-250-crore-through-qip-11605251148224.html,4,4,2,2,https://companies/news/multiplex-operator-inox-leisure-raises-rs-250-crore-through-qip
344,https://companies/news/ril-appoints-former-indian-oil-chairman-sanjiv-singh-as-group-president/amp-11598437071251.html,4,4,1,3,https://companies/news/ril-appoints-former-indian-oil-chairman-sanjiv-singh-as-group-president/amp
345,https://companies/news/uncertainty-over-fds-in-dhfl-s-resolution/amp-11605056419960.html,4,4,1,3,https://companies/news/uncertainty-over-fds-in-dhfl-s-resolution/amp
346,https://companies/people/ajay-tyagi-gets-an-extension-of-18-months-as-sebi-chief/amp-11596634912323.html,4,4,2,2,https://companies/people/ajay-tyagi-gets-an-extension-of-18-months-as-sebi-chief/amp
347,https://companies/start-ups/deepika-padukone-invests-in-maker-of-epigamia-yogurt/amp-1557771851043.html,4,4,1,3,companies/start-ups/deepika-padukone-invests-in-maker-of-epigamia-yogurt/amp-1557771851043.html
348,https://companies/start-ups/two-wheeler-rental-firm-bounce-looks-to-ride-into-smaller-cities/amp-1562781545404.html,4,4,3,1,companies/start-ups/two-wheeler-rental-firm-bounce-looks-to-ride-into-smaller-cities/amp-1562781545404.html
349,https://industry/advertising/virat-kohli-rishabh-pant-to-endorse-himalaya-men-face-care-range/amp-1557993471656.html,4,3,3,0,industry/advertising/virat-kohli-rishabh-pant-to-endorse-himalaya-men-face-care-range/amp-1557993471656.html
350,https://industry/banking/loan-defaults-hit-nbfcs-fintech-firms-the-hardest/amp-11605574486543.html?__twitter_impression=true&s=09,4,4,1,3,https://industry/banking/loan-defaults-hit-nbfcs-fintech-firms-the-hardest/amp-11605574486543.html?__twitter_impression=true&s=09
351,https://industry/energy/govt-cuts-gas-price-by-25-to-lowest-on-record/amp-11601472586101.html,4,3,0,3,https://industry/energy/govt-cuts-gas-price-by-25-to-lowest-on-record/amp
352,https://industry/manufacturing/tesla-s-entry-may-electrify-ev-sector/amp-11602030792518.html,4,3,2,1,https://industry/manufacturing/tesla-s-entry-may-electrify-ev-sector/amp
353,https://industry/retail/tata-group-is-building-an-indian-zara-where-everything-is-cheaper/amp-1561346476864.html,4,4,2,2,industry/retail/tata-group-is-building-an-indian-zara-where-everything-is-cheaper/amp-1561346476864.html
354,https://insurance/news/life-insurance-policy-grace-period-for-premium-payment-extended-further/amp-11589105800386.html,4,4,2,2,https://insurance/news/life-insurance-policy-grace-period-for-premium-payment-extended-further/amp
355,https://market/ipo/shanghai-stock-exchange-suspends-ant-group-s-a-share-ipo/amp-11604412338257.html,4,3,1,2,https://market/ipo/shanghai-stock-exchange-suspends-ant-group-s-a-share-ipo/amp
356,https://market/mark-to-market/sbi-life-delivers-on-growth-metrics-but-profitability-underwhelms-11603773813425.html,4,4,0,4,https://market/mark-to-market/sbi-life-delivers-on-growth-metrics-but-profitability-underwhelms
357,https://market/stock-market-news/dow-slumps-over-360-pts-on-rising-coronavirus-cases-fading-stimulus-hopes-11603721300802.html,4,2,0,2,https://market/stock-market-news/dow-slumps-over-360-pts-on-rising-coronavirus-cases-fading-stimulus-hopes
358,https://market/stock-market-news/sensex-breaches-44-000-mark-as-vaccine-optimism-leads-markets-to-new-high/amp-11605590714000.html,4,4,2,2,https://market/stock-market-news/sensex-breaches-44-000-mark-as-vaccine-optimism-leads-markets-to-new-high/amp
359,https://mint-lounge/features/70-years-of-1984-digital-dystopia-in-the-world-of-video-games-1561712668284.html,4,2,1,1,mint-lounge/features/70-years-of-1984-digital-dystopia-in-the-world-of-video-games-1561712668284.html
360,https://mint-lounge/features/priyamvada-gopal-s-white-lives-tweet-matters-here-s-why-11593512962676.html,4,3,2,1,https://mint-lounge/features/priyamvada-gopal-s-white-lives-tweet-matters-here-s-why
361,https://money/personal-finance/a-daughter-has-an-equal-right-to-that-of-a-son-on-ancestral-property-11598979896164.html,4,4,1,3,https://money/personal-finance/a-daughter-has-an-equal-right-to-that-of-a-son-on-ancestral-property
362,https://money/personal-finance/epf-ppf-among-assets-that-enjoy-legal-protection-from-court-attachment-1556706885816.html,4,3,2,1,money/personal-finance/epf-ppf-among-assets-that-enjoy-legal-protection-from-court-attachment-1556706885816.html
363,https://money/personal-finance/hsbc-india-launches-green-deposit-programme-to-finance-eco-friendly-projects-11597940240440.html,4,4,3,1,https://money/personal-finance/hsbc-india-launches-green-deposit-programme-to-finance-eco-friendly-projects
364,https://money/personal-finance/ltc-cash-voucher-scheme-return-cash-payout-to-the-employer-if-you-spend-less/amp-11604115122805.html,4,3,0,3,https://money/personal-finance/ltc-cash-voucher-scheme-return-cash-payout-to-the-employer-if-you-spend-less/amp
365,https://money/personal-finance/register-property-release-deed-with-the-sub-registrar-of-assurances/amp-11579601021119.html,4,2,0,2,https://money/personal-finance/register-property-release-deed-with-the-sub-registrar-of-assurances/amp
366,https://money/personal-finance/what-is-stamp-duty-and-what-is-it-charged-for-1551015799344.html,4,4,2,2,money/personal-finance/what-is-stamp-duty-and-what-is-it-charged-for-1551015799344.html
367,https://mutual-fund/mf-news/sip-inflows-drop-for-6th-month-in-sept-investors-prefer-to-maintain-liquidity-11602590605845.html,4,3,1,2,https://mutual-fund/mf-news/sip-inflows-drop-for-6th-month-in-sept-investors-prefer-to-maintain-liquidity
368,https://news/india/8-ncr-districts-make-up-over-one-third-of-active-coronavirus-cases-in-up/amp-11594227601699.html,4,4,1,3,https://news/india/8-ncr-districts-make-up-over-one-third-of-active-coronavirus-cases-in-up/amp
369,https://news/india/ayushman-bharat-beneficiaries-to-get-assistance-of-up-to-15-lakh-under-ran/amp-11581506645536.html,4,2,2,0,https://news/india/ayushman-bharat-beneficiaries-to-get-assistance-of-up-to-15-lakh-under-ran/amp
370,https://news/india/come-2022-here-s-how-delhi-meerut-regional-rapid-transit-system-will-look-like-11601038779749.html,4,4,2,2,https://news/india/come-2022-here-s-how-delhi-meerut-regional-rapid-transit-system-will-look-like
371,https://news/india/covid-19-update-active-covid-cases-in-india-fall-below-7-lakh-as-nearly-74-000-recover-in-a-day-11603424620149.html,4,2,0,2,https://news/india/covid-19-update-active-covid-cases-in-india-fall-below-7-lakh-as-nearly-74-000-recover-in-a-day
372,https://news/india/do-not-let-the-babu-concept-influence-you-pm-tells-civil-service-probationers-11604129568727.html,4,4,2,2,https://news/india/do-not-let-the-babu-concept-influence-you-pm-tells-civil-service-probationers
373,https://news/india/good-samaritan-govt-notifies-laws-to-protect-people-who-help-accident-victims-11601539127768.html,4,3,3,0,https://news/india/good-samaritan-govt-notifies-laws-to-protect-people-who-help-accident-victims
374,https://news/india/hiring-activities-in-hospitality-travel-industry-improve-in-october-naukri-com/amp-11605100436589.html,4,3,2,1,https://news/india/hiring-activities-in-hospitality-travel-industry-improve-in-october-naukri-com/amp
375,https://news/india/india-receives-single-largest-infra-loan-from-kfw-for-mumbai-metro/amp-11604662719908.html,4,4,0,4,https://news/india/india-receives-single-largest-infra-loan-from-kfw-for-mumbai-metro/amp
376,https://news/india/indigo-completes-replacing-pw-engines-powering-its-a320-neo-fleet/amp-11598610472852.html,4,3,1,2,https://news/india/indigo-completes-replacing-pw-engines-powering-its-a320-neo-fleet/amp
377,https://news/india/lockdown-in-tamil-nadu-extended-till-30-sept-but-with-most-restrictions-eased-11598798929030.html,4,3,2,1,https://news/india/lockdown-in-tamil-nadu-extended-till-30-sept-but-with-most-restrictions-eased
378,https://news/india/neet-to-be-held-tomorrow-for-over-15-lakh-candidates-amid-strict-covid-19-precautions-11599913386533.html,4,3,0,3,https://news/india/neet-to-be-held-tomorrow-for-over-15-lakh-candidates-amid-strict-covid-19-precautions
379,https://news/india/pm-modi-to-inaugurate-vaibhav-summit-today-11601608030018.html,4,3,3,0,https://news/india/pm-modi-to-inaugurate-vaibhav-summit-today
380,https://news/india/sbi-to-recruit-2000-probationary-officers-po-check-eligibility-and-other-details-here/amp-11605410033248.html?__twitter_impression=true,4,4,3,1,https://news/india/sbi-to-recruit-2000-probationary-officers-po-check-eligibility-and-other-details-here/amp-11605410033248.html?__twitter_impression=true
381,https://news/india/the-growing-clamour-for-an-urban-jobs-scheme-11601903485203.html,4,4,0,4,https://news/india/the-growing-clamour-for-an-urban-jobs-scheme
382,https://news/india/when-democracy-fails-the-poor-11602040759209.html,4,2,1,1,https://news/india/when-democracy-fails-the-poor
383,https://news/world/china-set-to-start-trial-of-nasal-spray-covid-19-vaccine-11604902461202.html,4,3,2,1,https://news/world/china-set-to-start-trial-of-nasal-spray-covid-19-vaccine
384,https://news/world/russia-resumes-covid-19-vaccine-trial-after-pause/amp-11605779723408.html?__twitter_impression=true,4,4,2,2,https://news/world/russia-resumes-covid-19-vaccine-trial-after-pause/amp-11605779723408.html?__twitter_impression=true
385,https://opinion/columns/opinion-economic-geography-central-to-india-s-regional-inequality-woes/amp-1556647599599.html,4,2,2,0,opinion/columns/opinion-economic-geography-central-to-india-s-regional-inequality-woes/amp-1556647599599.html
386,https://opinion/online-views/opinion-how-can-india-become-an-agricultural-powerhouse-post-coronavirus/amp-11591508334787.html,4,3,2,1,https://opinion/online-views/opinion-how-can-india-become-an-agricultural-powerhouse-post-coronavirus/amp
387,https://politics/news/telangana-bjp-appoints-bhupender-yadav-as-election-incharge-for-upcoming-ghmc-polls-11605444842521.html,4,3,1,2,https://politics/news/telangana-bjp-appoints-bhupender-yadav-as-election-incharge-for-upcoming-ghmc-polls
388,https://science/health/covid-19-vaccine-race-spotlight-on-pfizer-moderna-as-trial-data-to-be-released-soon-11601976571287.html,4,4,0,4,https://science/health/covid-19-vaccine-race-spotlight-on-pfizer-moderna-as-trial-data-to-be-released-soon
389,https://technology/apps/whatsapp-latest-feature-now-search-across-your-chats-more-easily/amp-11584010629021.html,4,4,4,0,https://technology/apps/whatsapp-latest-feature-now-search-across-your-chats-more-easily/amp
390,https://technology/tech-news/govt-warns-of-serious-phishing-attack-starting-today-beware-of-this-email-id-11592718991047.html,4,3,2,1,https://technology/tech-news/govt-warns-of-serious-phishing-attack-starting-today-beware-of-this-email-id
391,https://technology/tech-reviews/airtel-xstream-a-chromecast-but-only-for-airtel-subscribers-11576165779214.html,4,4,4,0,https://technology/tech-reviews/airtel-xstream-a-chromecast-but-only-for-airtel-subscribers
392,https://v/s/www.livemint.com/news/world/how-jack-ma-blew-ant-s-35-billion-ipo/amp-11605706616879.html?amp_js_v=0.1&usqp=mq331AQFKAGwASA=,4,1,0,1,https://v/s/www.livemint.com/news/world/how-jack-ma-blew-ant-s-35-billion-ipo/amp-11605706616879.html?amp_js_v=0.1&usqp=mq331AQFKAGwASA=
393,https://Companies/6WaSXrjWbE14UzhVcf6MCI/Sharp-drop-in-travel-agents-in-India-with-Iata-accreditation.html?facet=amp,3,3,2,1,companies/6WaSXrjWbE14UzhVcf6MCI/Sharp-drop-in-travel-agents-in-India-with-Iata-accreditation.html?facet=amp
394,https://Companies/IECJ5J1MJS8PTZpkZ439NN/Twitter-says-India-revenue-has-tripled.html,3,2,0,2,companies/IECJ5J1MJS8PTZpkZ439NN/Twitter-says-India-revenue-has-tripled.html
395,https://Companies/StULwUcXxoys0JEi2NJ6yO/CRIS-has-become-the-backbone-of-Indian-Railways-Sanjaya-Das.html,3,3,2,1,companies/StULwUcXxoys0JEi2NJ6yO/CRIS-has-become-the-backbone-of-Indian-Railways-Sanjaya-Das.html
396,https://Companies/azRCLZeTgjBYVvjzvf1vaO/Patanjali-to-turn-into-a-nonprofit-organization-Baba-Ramde.html,3,3,2,1,companies/azRCLZeTgjBYVvjzvf1vaO/Patanjali-to-turn-into-a-nonprofit-organization-Baba-Ramde.html
397,https://Companies/m49HOIKJfn3CxCICy62R9I/One-winner-one-loser-in-Ofer-brothers-lottery-worth-billio.html?facet=amp,3,3,3,0,companies/m49HOIKJfn3CxCICy62R9I/One-winner-one-loser-in-Ofer-brothers-lottery-worth-billio.html?facet=amp
398,https://Companies/vU1NSyLeitWFe3UioxPPvL/Salary-wars-brew-among-top-law-firms.html?facet=amp,3,3,1,2,companies/vU1NSyLeitWFe3UioxPPvL/Salary-wars-brew-among-top-law-firms.html?facet=amp
399,https://Consumer/MSSonwarPqFFCkpCXICGhN/Why-India-doesnt-love-Star-Wars.html?facet=amp,3,2,1,1,consumer/MSSonwarPqFFCkpCXICGhN/Why-India-doesnt-love-Star-Wars.html?facet=amp
400,https://Consumer/xrILAZp28LE2lKRi9Lmm0O/Surf-Excels-new-ad-campaign-looks-to-update-dirt-is-good.html?facet=amp,3,3,2,1,consumer/xrILAZp28LE2lKRi9Lmm0O/Surf-Excels-new-ad-campaign-looks-to-update-dirt-is-good.html?facet=amp
401,https://Epaper/M/Delhi/20/10/2020/Page/00,3,1,0,1,epaper/M/Delhi/20/10/2020/Page/00
402,https://Home-Page/0xIDW14Y7A41x9IKaWlL2H/docs.google.com/forms/d/e/1FAIpQLScqDRJVOQUGGpZEKSWNei6GIwROSmK8J2n2f4J7dEHAxMmmjg/docs.google.com/forms/d/e/1FAIpQLScqDRJVOQUGGpZEKSWNei6GIwROSmK8J2n2f4J7dEHAxMmmjg/docs.google.com/forms/d/e/1FAIpQLScqDRJVOQUGGpZEKSWNei6GIwROSmK8J2n2f4J7dEHAxMmmjg/docs.google.com/forms/d/e/1FAIpQLScqDRJVOQUGGpZEKSWNei6GIwROSmK8J2n2f4J7dEHAxMmmjg/docs.google.com/forms/d/e/1FAIpQLScqDRJVOQUGGpZEKSWNei6GIwROSmK8J2n2f4J7dEHAxMmmjg/docs.google.com/forms/d/e/1FAIpQLScqDRJVOQUGGpZEKSWNei6GIwROSmK8J2n2f4J7dEHAxMmmjg/docs.google.com/forms/d/e/1FAIpQLScqDRJVOQUGGpZEKSWNei6GIwROSmK8J2n2f4J7dEHAxMmmjg/docs.google.com/forms/d/e/1FAIpQLScqDRJVOQUGGpZEKSWNei6GIwROSmK8J2n2f4J7dEHAxMmmjg/docs.google.com/forms/d/e/1FAIpQLScqDRJVOQUGGpZEKSWNei6GIwROSmK8J2n2f4J7dEHAxMmmjg/docs.google.com/forms/d/e/1FAIpQLScqDRJVOQUGGpZEKSWNei6GIwROSmK8J2n2f4J7dEHAxMmmjg/docs.google.com/forms/d/e/1FAIpQLScqDRJVOQUGGpZEKSWNei6GIwROSmK8J2n2f4J7dEHAxMmmjg/docs.google.com/forms/d/e/1FAIpQLScqDRJVOQUGGpZEKSWNei6GIwROSmK8J2n2f4J7dEHAxMmmjg/docs.google.com/forms/d/e/1FAIpQLScqDRJVOQUGGpZEKSWNei6GIwROSmK8J2n2f4J7dEHAxMmmjg/docs.google.com/forms/d/e/1FAIpQLScqDRJVOQUGGpZEKSWNei6GIwROSmK8J2n2f4J7dEHAxMmmjg/docs.google.com/forms/d/e/1FAIpQLScqDRJVOQUGGpZEKSWNei6GIwROSmK8J2n2f4J7dEHAxMmmjg/docs.google.com/forms/d/e/1FAIpQLScqDRJVOQUGGpZEKSWNei6GIwROSmK8J2n2f4J7dEHAxMmmjg/docs.google.com/forms/d/e/1FAIpQLScqDRJVOQUGGpZEKSWNei6GIwROSmK8J2n2f4J7dEHAxMmmjg/docs.google.com/forms/d/e/1FAIpQLScqDRJVOQUGGpZEKSWNei6GIwROSmK8J2n2f4J7dEHAxMmmjg/docs.google.com/forms/d/e/1FAIpQLScqDRJVOQUGGpZEKSWNei6GIwROSmK8J2n2f4J7dEHAxMmmjg/docs.google.com/forms/d/e/1FAIpQLScqDRJVOQUGGpZEKSWNei6GIwROSmK8J2n2f4J7dEHAxMmmjg/docs.google.com/forms/d/e/1FAIpQLScqDRJVOQUGGpZEKSWNei6GIwROSmK8J2n2f4J7dEHAxMmmjg/docs.google.com/forms/d/e/1FAIpQLScqDRJVOQUGGpZEKSWNei6GIwROSmK8J2n2f4J7dEHAxMmmjg/docs.google.com/forms/d/e/1FAIpQLScqDRJVOQUGGpZEKSWNei6GIwROSmK8J2n2f4J7dEHAxMmmjg/docs.google.com/forms/d/e/1FAIpQLScqDRJVOQUGGpZEKSWNei6GIwROSmK8J2n2f4J7dEHAxMmmjg/docs.google.com/forms/d/e/1FAIpQLScqDRJVOQUGGpZEKSWNei6GIwROSmK8J2n2f4J7dEHAxMmmjg/docs.google.com/forms/d/e/1FAIpQLScqDRJVOQUGGpZEKSWNei6GIwROSmK8J2n2f4J7dEHAxMmmjg/docs.google.com/forms/d/e/1FAIpQLScqDRJVOQUGGpZEKSWNei6GIwROSmK8J2n2f4J7dEHAxMmmjg/docs.google.com/forms/d/e/1FAIpQLScqDRJVOQUGGpZEKSWNei6GIwROSmK8J2n2f4J7dEHAxMmmjg/docs.google.com/forms/d/e/1FAIpQLScqDRJVOQUGGpZEKSWNei6GIwROSmK8J2n2f4J7dEHAxMmmjg/docs.google.com/forms/d/e/1FAIpQLScqDRJVOQUGGpZEKSWNei6GIwROSmK8J2n2f4J7dEHAxMmmjg/docs.google.com/forms/d/e/1FAIpQLScqDRJVOQUGGpZEKSWNei6GIwROSmK8J2n2f4J7dEHAxMmmjg/docs.google.com/forms/d/e/1FAIpQLScqDRJVOQUGGpZEKSWNei6GIwROSmK8J2n2f4J7dEHAxMmmjg/docs.google.com/forms/d/e/1FAIpQLScqDRJVOQUGGpZEKSWNei6GIwROSmK8J2n2f4J7dEHAxMmmjg/docs.google.com/forms/d/e/1FAIpQLScqDRJVOQUGGpZEKSWNei6GIwROSmK8J2n2f4J7dEHAxMmmjg/docs.google.com/forms/d/e/1FAIpQLScqDRJVOQUGGpZEKSWNei6GIwROSmK8J2n2f4J7dEHAxMmmjg/docs.google.com/forms/d/e/1FAIpQLScqDRJVOQUGGpZEKSWNei6GIwROSmK8J2n2f4J7dEHAxMmmjg/docs.google.com/forms/d/e/1FAIpQLScqDRJVOQUGGpZEKSWNei6GIwROSmK8J2n2f4J7dEHAxMmmjg/docs.google.com/forms/d/e/1FAIpQLScqDRJVOQUGGpZEKSWNei6GIwROSmK8J2n2f4J7dEHAxMmmjg/viewform?embedded=true,3,1,0,1,home-page/0xIDW14Y7A41x9IKaWlL2H/docs.google.com/forms/d/e/1FAIpQLScqDRJVOQUGGpZEKSWNei6GIwROSmK8J2n2f4J7dEHAxMmmjg/docs.google.com/forms/d/e/1FAIpQLScqDRJVOQUGGpZEKSWNei6GIwROSmK8J2n2f4J7dEHAxMmmjg/docs.google.com/forms/d/e/1FAIpQLScqDRJVOQUGGpZEKSWNei6GIwROSmK8J2n2f4J7dEHAxMmmjg/docs.google.com/forms/d/e/1FAIpQLScqDRJVOQUGGpZEKSWNei6GIwROSmK8J2n2f4J7dEHAxMmmjg/docs.google.com/forms/d/e/1FAIpQLScqDRJVOQUGGpZEKSWNei6GIwROSmK8J2n2f4J7dEHAxMmmjg/docs.google.com/forms/d/e/1FAIpQLScqDRJVOQUGGpZEKSWNei6GIwROSmK8J2n2f4J7dEHAxMmmjg/docs.google.com/forms/d/e/1FAIpQLScqDRJVOQUGGpZEKSWNei6GIwROSmK8J2n2f4J7dEHAxMmmjg/docs.google.com/forms/d/e/1FAIpQLScqDRJVOQUGGpZEKSWNei6GIwROSmK8J2n2f4J7dEHAxMmmjg/docs.google.com/forms/d/e/1FAIpQLScqDRJVOQUGGpZEKSWNei6GIwROSmK8J2n2f4J7dEHAxMmmjg/docs.google.com/forms/d/e/1FAIpQLScqDRJVOQUGGpZEKSWNei6GIwROSmK8J2n2f4J7dEHAxMmmjg/docs.google.com/forms/d/e/1FAIpQLScqDRJVOQUGGpZEKSWNei6GIwROSmK8J2n2f4J7dEHAxMmmjg/docs.google.com/forms/d/e/1FAIpQLScqDRJVOQUGGpZEKSWNei6GIwROSmK8J2n2f4J7dEHAxMmmjg/docs.google.com/forms/d/e/1FAIpQLScqDRJVOQUGGpZEKSWNei6GIwROSmK8J2n2f4J7dEHAxMmmjg/docs.google.com/forms/d/e/1FAIpQLScqDRJVOQUGGpZEKSWNei6GIwROSmK8J2n2f4J7dEHAxMmmjg/docs.google.com/forms/d/e/1FAIpQLScqDRJVOQUGGpZEKSWNei6GIwROSmK8J2n2f4J7dEHAxMmmjg/docs.google.com/forms/d/e/1FAIpQLScqDRJVOQUGGpZEKSWNei6GIwROSmK8J2n2f4J7dEHAxMmmjg/docs.google.com/forms/d/e/1FAIpQLScqDRJVOQUGGpZEKSWNei6GIwROSmK8J2n2f4J7dEHAxMmmjg/docs.google.com/forms/d/e/1FAIpQLScqDRJVOQUGGpZEKSWNei6GIwROSmK8J2n2f4J7dEHAxMmmjg/docs.google.com/forms/d/e/1FAIpQLScqDRJVOQUGGpZEKSWNei6GIwROSmK8J2n2f4J7dEHAxMmmjg/docs.google.com/forms/d/e/1FAIpQLScqDRJVOQUGGpZEKSWNei6GIwROSmK8J2n2f4J7dEHAxMmmjg/docs.google.com/forms/d/e/1FAIpQLScqDRJVOQUGGpZEKSWNei6GIwROSmK8J2n2f4J7dEHAxMmmjg/docs.google.com/forms/d/e/1FAIpQLScqDRJVOQUGGpZEKSWNei6GIwROSmK8J2n2f4J7dEHAxMmmjg/docs.google.com/forms/d/e/1FAIpQLScqDRJVOQUGGpZEKSWNei6GIwROSmK8J2n2f4J7dEHAxMmmjg/docs.google.com/forms/d/e/1FAIpQLScqDRJVOQUGGpZEKSWNei6GIwROSmK8J2n2f4J7dEHAxMmmjg/docs.google.com/forms/d/e/1FAIpQLScqDRJVOQUGGpZEKSWNei6GIwROSmK8J2n2f4J7dEHAxMmmjg/docs.google.com/forms/d/e/1FAIpQLScqDRJVOQUGGpZEKSWNei6GIwROSmK8J2n2f4J7dEHAxMmmjg/docs.google.com/forms/d/e/1FAIpQLScqDRJVOQUGGpZEKSWNei6GIwROSmK8J2n2f4J7dEHAxMmmjg/docs.google.com/forms/d/e/1FAIpQLScqDRJVOQUGGpZEKSWNei6GIwROSmK8J2n2f4J7dEHAxMmmjg/docs.google.com/forms/d/e/1FAIpQLScqDRJVOQUGGpZEKSWNei6GIwROSmK8J2n2f4J7dEHAxMmmjg/docs.google.com/forms/d/e/1FAIpQLScqDRJVOQUGGpZEKSWNei6GIwROSmK8J2n2f4J7dEHAxMmmjg/docs.google.com/forms/d/e/1FAIpQLScqDRJVOQUGGpZEKSWNei6GIwROSmK8J2n2f4J7dEHAxMmmjg/docs.google.com/forms/d/e/1FAIpQLScqDRJVOQUGGpZEKSWNei6GIwROSmK8J2n2f4J7dEHAxMmmjg/docs.google.com/forms/d/e/1FAIpQLScqDRJVOQUGGpZEKSWNei6GIwROSmK8J2n2f4J7dEHAxMmmjg/docs.google.com/forms/d/e/1FAIpQLScqDRJVOQUGGpZEKSWNei6GIwROSmK8J2n2f4J7dEHAxMmmjg/docs.google.com/forms/d/e/1FAIpQLScqDRJVOQUGGpZEKSWNei6GIwROSmK8J2n2f4J7dEHAxMmmjg/docs.google.com/forms/d/e/1FAIpQLScqDRJVOQUGGpZEKSWNei6GIwROSmK8J2n2f4J7dEHAxMmmjg/docs.google.com/forms/d/e/1FAIpQLScqDRJVOQUGGpZEKSWNei6GIwROSmK8J2n2f4J7dEHAxMmmjg/docs.google.com/forms/d/e/1FAIpQLScqDRJVOQUGGpZEKSWNei6GIwROSmK8J2n2f4J7dEHAxMmmjg/viewform?embedded=true
403,https://Home-Page/jcOqCbs1NHao1ys7h0CSyH/Pfizer8217s-antismoking-drug-in-India-despite-US-regulat.html?facet=amp,3,3,2,1,home-page/jcOqCbs1NHao1ys7h0CSyH/Pfizer8217s-antismoking-drug-in-India-despite-US-regulat.html?facet=amp
404,https://Home/MShareImage?Pictureid=1911c8c620a8,3,2,0,2,home/MShareImage?Pictureid=1911c8c620a8
405,https://Home/mIndex?_we_linker=1*9ib7d7*we_luid*YW1wLWZQdFAwemlXZzhnbS1veWJjZmwtT0E.,3,1,0,1,home/mIndex?_we_linker=1*9ib7d7*we_luid*YW1wLWZQdFAwemlXZzhnbS1veWJjZmwtT0E.
406,https://Industry/IL7nR6USe1un4vgIcnYhdJ/The-sober-reality-of-making-liquor-in-India.html,3,3,2,1,industry/IL7nR6USe1un4vgIcnYhdJ/The-sober-reality-of-making-liquor-in-India.html
407,https://Industry/heHyiUVLG806xv37Ltfm5M/Reliance-Industries-emerges-sole-contender-to-acquire-stake.html?facet=amp,3,2,0,2,industry/heHyiUVLG806xv37Ltfm5M/Reliance-Industries-emerges-sole-contender-to-acquire-stake.html?facet=amp
408,https://Leisure/3NPybJyH0d04sqXine2CCK/Six-feet-under.html,3,3,2,1,leisure/3NPybJyH0d04sqXine2CCK/Six-feet-under.html
409,https://Leisure/ERolPmBEbrq0CwmpkVuEUN/The-Quorum-Changing-the-status-quo.html?facet=amp,3,3,2,1,leisure/ERolPmBEbrq0CwmpkVuEUN/The-Quorum-Changing-the-status-quo.html?facet=amp
410,https://Leisure/N7FBbGjeLotufVA8sLjyUM/Delhis-Belly--The-real-naked-fakir.html?facet=amp,3,3,3,0,leisure/N7FBbGjeLotufVA8sLjyUM/Delhis-Belly--The-real-naked-fakir.html?facet=amp
411,https://Leisure/X49J4MzG0fwPPtYK93mIxN/The-other-side-of-Khirki.html?facet=amp,3,3,3,0,leisure/X49J4MzG0fwPPtYK93mIxN/The-other-side-of-Khirki.html?facet=amp
412,https://Leisure/hWXj79qPmqpG9n6KaLBKPK/Kolkata-Chromosome--Kiss-me-in-the-cabin.html,3,3,2,1,leisure/hWXj79qPmqpG9n6KaLBKPK/Kolkata-Chromosome--Kiss-me-in-the-cabin.html
413,https://Leisure/rzDZikAcCrjpmuiw8lHEVL/Stories-we-dont-hear.html?facet=amp,3,1,0,1,leisure/rzDZikAcCrjpmuiw8lHEVL/Stories-we-dont-hear.html?facet=amp
414,https://Leisure/zYEgmRno5tPeWYhSok8nJN/Channapatna-Karnataka--Back-in-the-game.html,3,3,3,0,leisure/zYEgmRno5tPeWYhSok8nJN/Channapatna-Karnataka--Back-in-the-game.html
415,https://Money/83kpXpBCGQNOaYXwkNquCI/Reduction-in-yield-RIY-when-calculating-Ulip-returns.html,3,3,2,1,money/83kpXpBCGQNOaYXwkNquCI/Reduction-in-yield-RIY-when-calculating-Ulip-returns.html
416,https://Money/Hs14rr4STCHrZhc9OzS3DM/Palani-Hills-may-lose-unique-banana-varieties-to-virus.html?facet=amp,3,1,0,1,money/Hs14rr4STCHrZhc9OzS3DM/Palani-Hills-may-lose-unique-banana-varieties-to-virus.html?facet=amp
417,https://Money/QBzivjaiKd9YweXoOpzsrJ/How-a-cash-recycler-machine-differs-from-an-automated-teller.html,3,3,2,1,money/QBzivjaiKd9YweXoOpzsrJ/How-a-cash-recycler-machine-differs-from-an-automated-teller.html
418,https://Money/YMzInyn7AR5BDN5QX0Jz7K/You-can-claim-deduction-of-30-towards-repairs-from-gross-re.html,3,3,2,1,money/YMzInyn7AR5BDN5QX0Jz7K/You-can-claim-deduction-of-30-towards-repairs-from-gross-re.html
419,https://Money/iQBsfungcPZKA2kVglgm7H/Why-you-should-use-the-RERA-website-before-buying-property.html,3,3,1,2,money/iQBsfungcPZKA2kVglgm7H/Why-you-should-use-the-RERA-website-before-buying-property.html
420,https://Money/t9THPjuPHnQ025VGbrydwL/DYK-You-must-inform-bank-if-you-continue-your-salary-accoun.html,3,2,2,0,money/t9THPjuPHnQ025VGbrydwL/DYK-You-must-inform-bank-if-you-continue-your-salary-accoun.html
421,https://Opinion/2wuxdFKDcOYhsijbaOg1uI/What-your-lips-say-about-you.html,3,3,3,0,opinion/2wuxdFKDcOYhsijbaOg1uI/What-your-lips-say-about-you.html
422,https://Opinion/HziUVKc2XnZxidRD3rjqVL/Rural-income-looking-beyond-agriculture.html,3,3,1,2,opinion/HziUVKc2XnZxidRD3rjqVL/Rural-income-looking-beyond-agriculture.html
423,https://Opinion/VYQm1rvYY4iAEIBL4a10AM/A-transformation-of-corporate-governance.html,3,3,3,0,opinion/VYQm1rvYY4iAEIBL4a10AM/A-transformation-of-corporate-governance.html
424,https://Opinion/hHWPst1Oop8oyJSlkzw8OL/What-is-the-ISI-mark-all-about.html,3,3,3,0,opinion/hHWPst1Oop8oyJSlkzw8OL/What-is-the-ISI-mark-all-about.html
425,https://Opinion/t7Wpt9fu57OIimiSwuwVRM/The-degradation-of-Indian-universities-through-politics.html,3,2,1,1,opinion/t7Wpt9fu57OIimiSwuwVRM/The-degradation-of-Indian-universities-through-politics.html
426,https://Politics/28q9vf3FP7bU8JaIPpX0pL/Seven-large-penalties-imposed-by-CCI.html,3,3,2,1,politics/28q9vf3FP7bU8JaIPpX0pL/Seven-large-penalties-imposed-by-CCI.html
427,https://Politics/5HU9KriaUIbYUaPdvdvtsO/www.thinglink.com/card/www.thinglink.com/card/www.thinglink.com/card/www.thinglink.com/card/www.thinglink.com/card/www.thinglink.com/card/www.thinglink.com/card/www.thinglink.com/card/www.thinglink.com/card/www.thinglink.com/card/www.thinglink.com/card/www.thinglink.com/card/www.thinglink.com/card/www.thinglink.com/card/www.thinglink.com/card/www.thinglink.com/card/www.thinglink.com/card/www.thinglink.com/card/www.thinglink.com/card/www.thinglink.com/card/www.thinglink.com/card/www.thinglink.com/card/www.thinglink.com/card/www.thinglink.com/card/www.thinglink.com/card/www.thinglink.com/card/www.thinglink.com/card/www.thinglink.com/card/www.thinglink.com/card/www.thinglink.com/card/www.thinglink.com/card/www.thinglink.com/card/www.thinglink.com/card/www.thinglink.com/card/www.thinglink.com/card/www.thinglink.com/card/www.thinglink.com/card/www.thinglink.com/card/www.thinglink.com/card/www.thinglink.com/card/www.thinglink.com/card/www.thinglink.com/card/www.thinglink.com/card/www.thinglink.com/card/www.thinglink.com/card/www.thinglink.com/card/www.thinglink.com/card/www.thinglink.com/card/www.thinglink.com/card/www.thinglink.com/card/www.thinglink.com/card/www.thinglink.com/card/www.thinglink.com/card/www.thinglink.com/card/www.thinglink.com/card/www.thinglink.com/card/www.thinglink.com/card/www.thinglink.com/card/www.thinglink.com/card/www.thinglink.com/card/www.thinglink.com/card/www.thinglink.com/card/www.thinglink.com/card/www.thinglink.com/card/www.thinglink.com/card/www.thinglink.com/card/www.thinglink.com/card/www.thinglink.com/card/www.thinglink.com/card/www.thinglink.com/card/www.thinglink.com/card/www.thinglink.com/card/www.thinglink.com/card/www.thinglink.com/card/www.thinglink.com/card/www.thinglink.com/card/www.thinglink.com/card/www.thinglink.com/card/www.thinglink.com/card/www.thinglink.com/card/www.thinglink.com/card/www.thinglink.com/card/www.thinglink.com/card/www.thinglink.com/card/www.thinglink.com/card/www.thinglink.com/card/www.thinglink.com/card/611491258145177600,3,2,0,2,politics/5HU9KriaUIbYUaPdvdvtsO/www.thinglink.com/card/www.thinglink.com/card/www.thinglink.com/card/www.thinglink.com/card/www.thinglink.com/card/www.thinglink.com/card/www.thinglink.com/card/www.thinglink.com/card/www.thinglink.com/card/www.thinglink.com/card/www.thinglink.com/card/www.thinglink.com/card/www.thinglink.com/card/www.thinglink.com/card/www.thinglink.com/card/www.thinglink.com/card/www.thinglink.com/card/www.thinglink.com/card/www.thinglink.com/card/www.thinglink.com/card/www.thinglink.com/card/www.thinglink.com/card/www.thinglink.com/card/www.thinglink.com/card/www.thinglink.com/card/www.thinglink.com/card/www.thinglink.com/card/www.thinglink.com/card/www.thinglink.com/card/www.thinglink.com/card/www.thinglink.com/card/www.thinglink.com/card/www.thinglink.com/card/www.thinglink.com/card/www.thinglink.com/card/www.thinglink.com/card/www.thinglink.com/card/www.thinglink.com/card/www.thinglink.com/card/www.thinglink.com/card/www.thinglink.com/card/www.thinglink.com/card/www.thinglink.com/card/www.thinglink.com/card/www.thinglink.com/card/www.thinglink.com/card/www.thinglink.com/card/www.thinglink.com/card/www.thinglink.com/card/www.thinglink.com/card/www.thinglink.com/card/www.thinglink.com/card/www.thinglink.com/card/www.thinglink.com/card/www.thinglink.com/card/www.thinglink.com/card/www.thinglink.com/card/www.thinglink.com/card/www.thinglink.com/card/www.thinglink.com/card/www.thinglink.com/card/www.thinglink.com/card/www.thinglink.com/card/www.thinglink.com/card/www.thinglink.com/card/www.thinglink.com/card/www.thinglink.com/card/www.thinglink.com/card/www.thinglink.com/card/www.thinglink.com/card/www.thinglink.com/card/www.thinglink.com/card/www.thinglink.com/card/www.thinglink.com/card/www.thinglink.com/card/www.thinglink.com/card/www.thinglink.com/card/www.thinglink.com/card/www.thinglink.com/card/www.thinglink.com/card/www.thinglink.com/card/www.thinglink.com/card/www.thinglink.com/card/www.thinglink.com/card/www.thinglink.com/card/www.thinglink.com/card/www.thinglink.com/card/611491258145177600
428,https://Politics/67w3OQ4SyLCoU8ukWAGRyL/Why-Indian-Railways-has-failed-to-increase-nonfare-revenue.html,3,2,1,1,politics/67w3OQ4SyLCoU8ukWAGRyL/Why-Indian-Railways-has-failed-to-increase-nonfare-revenue.html
429,https://Politics/HUI50FwxMfih8ES32xSlPI/What-do-pilots-do-if-there-is-a-hijack-threat-onboard.html?facet=amp,3,3,2,1,politics/HUI50FwxMfih8ES32xSlPI/What-do-pilots-do-if-there-is-a-hijack-threat-onboard.html?facet=amp
430,https://Politics/Rn0AWNC5CzHYOmlAum0jTK/Increase-in-floor-area-ratio-for-Delhi-approved.html?facet=amp,3,3,1,2,politics/Rn0AWNC5CzHYOmlAum0jTK/Increase-in-floor-area-ratio-for-Delhi-approved.html?facet=amp
431,https://Politics/bmLJ0TQSLXo3RGmX8eIwCN/Approved-88-projects-worth-Rs42953-crore-in-4-years-GK-V.html?facet=amp,3,1,1,0,politics/bmLJ0TQSLXo3RGmX8eIwCN/Approved-88-projects-worth-Rs42953-crore-in-4-years-GK-V.html?facet=amp
432,https://Politics/qXiX9p9ViAPzupDjqsnlWN/What-does-100-FDI-in-aviation-mean.html,3,3,3,0,politics/qXiX9p9ViAPzupDjqsnlWN/What-does-100-FDI-in-aviation-mean.html
433,https://Science/LMgQKEAcoymrtpGz7JWSyJ/Artificial-intelligence-will-be-the-defining-tech-of-the-21s.html?facet=amp,3,2,1,1,science/LMgQKEAcoymrtpGz7JWSyJ/Artificial-intelligence-will-be-the-defining-tech-of-the-21s.html?facet=amp
434,https://Search/Link/Author/Vikas-Kumar,3,3,3,0,search/Link/Author/Vikas-Kumar
435,https://Search/Link/Keyword/Idbi-Bank-Npa,3,2,0,2,search/Link/Keyword/Idbi-Bank-Npa
436,https://Search/Link/Keyword/Sensex-Today,3,3,3,0,search/Link/Keyword/Sensex-Today
437,https://Search/Link/Keyword/housing,3,1,0,1,search/Link/Keyword/housing
438,https://Sundayapp/FU6sreM7t13piRRwkvdKfP/Secularism-and-principled-distance-How-Hinduism-was-nationa.html,3,3,1,2,sundayapp/FU6sreM7t13piRRwkvdKfP/Secularism-and-principled-distance-How-Hinduism-was-nationa.html
439,https://Technology/mvpdtX5SVUAHeClRAtBfuJ/PostCES-19-Will-gaming-laptops-finally-interest-progamer.html?facet=amp,3,3,1,2,technology/mvpdtX5SVUAHeClRAtBfuJ/PostCES-19-Will-gaming-laptops-finally-interest-progamer.html?facet=amp
440,https://auto-news/for-self-driving-cars-in-india-there-is-still-hope/amp-11578469548006.html,3,3,3,0,https://auto-news/for-self-driving-cars-in-india-there-is-still-hope/amp
441,https://auto-news/tata-motors-launches-india-s-biggest-tipper-truck-11597331990768.html,3,3,3,0,https://auto-news/tata-motors-launches-india-s-biggest-tipper-truck
442,https://budget/news,3,3,2,1,budget/news
443,https://companies/company-results/paper-boat-maker-posts-62-jump-in-fy19-revenue/amp-11575295955340.html,3,3,2,1,https://companies/company-results/paper-boat-maker-posts-62-jump-in-fy19-revenue/amp
444,https://companies/news/ael-plans-50-000-cr-capital-expenditure-over-five-years/amp-11604539879474.html,3,3,1,2,https://companies/news/ael-plans-50-000-cr-capital-expenditure-over-five-years/amp
445,https://companies/news/behind-samsung-s-116-billion-bid-for-chip-supremacy-11577113892784.html,3,3,3,0,https://companies/news/behind-samsung-s-116-billion-bid-for-chip-supremacy
446,https://companies/news/cold-chain-cos-gear-up-for-covid-vaccine-delivery-challenge/amp-11600739881786.html,3,3,2,1,https://companies/news/cold-chain-cos-gear-up-for-covid-vaccine-delivery-challenge/amp
447,https://companies/news/equitas-small-finance-bank-says-restrictions-removed-on-opening-of-new-branches/amp-11604906085979.html,3,3,2,1,https://companies/news/equitas-small-finance-bank-says-restrictions-removed-on-opening-of-new-branches/amp
448,https://companies/news/gst-reduction-and-other-benefits-have-created-the-right-framework-for-evs-in-india-mercedes-benz-11602164076418.html,3,3,2,1,https://companies/news/gst-reduction-and-other-benefits-have-created-the-right-framework-for-evs-in-india-mercedes-benz
449,https://companies/news/investment-banking-fees-rises-5-8-to-783-5-mn-during-jan-sep-11571934852066.html,3,2,1,1,https://companies/news/investment-banking-fees-rises-5-8-to-783-5-mn-during-jan-sep
450,https://companies/news/microsoft-india-most-attractive-employer-brand-survey-11595920573946.html,3,3,2,1,https://companies/news/microsoft-india-most-attractive-employer-brand-survey
451,https://companies/news/oyo-plans-to-reinstate-employee-salaries-in-a-phased-manner/amp-11596562966934.html,3,3,1,2,https://companies/news/oyo-plans-to-reinstate-employee-salaries-in-a-phased-manner/amp
452,https://companies/news/reliance-digital-s-digital-india-sale-details-here/amp-11596991733412.html,3,3,2,1,https://companies/news/reliance-digital-s-digital-india-sale-details-here/amp
453,https://companies/news/sony-viacom18-deal-by-mid-aug-11595980721928.html,3,3,0,3,https://companies/news/sony-viacom18-deal-by-mid-aug
454,https://companies/news/the-pill-economy-of-india-s-online-medicos-11572794132893.html,3,2,0,2,https://companies/news/the-pill-economy-of-india-s-online-medicos
455,https://companies/news/what-makes-jio-platforms-command-a-rs-5-trillion-valuation/amp-11588736360741.html,3,3,0,3,https://companies/news/what-makes-jio-platforms-command-a-rs-5-trillion-valuation/amp
456,https://companies/people/arvind-fashion-appoints-shailesh-chaturvedi-as-md-and-ceo-11605181074520.html,3,3,1,2,https://companies/people/arvind-fashion-appoints-shailesh-chaturvedi-as-md-and-ceo
457,https://companies/people/simple-man-of-simple-tastes-leads-disciplined-not-lavish-lifestyle-anil-ambani/amp-11601103098906.html,3,3,0,3,https://companies/people/simple-man-of-simple-tastes-leads-disciplined-not-lavish-lifestyle-anil-ambani/amp
458,https://companies/start-ups/for-nykaa-fashion-is-the-next-biggest-frontier/amp-11597405792384.html,3,3,0,3,https://companies/start-ups/for-nykaa-fashion-is-the-next-biggest-frontier/amp
459,https://companies/start-ups/the-unicorn-club-of-india/amp-11572955965504.html,3,2,1,1,https://companies/start-ups/the-unicorn-club-of-india/amp
460,https://education/news/mbbs-fees-in-medical-colleges-raised-in-haryana-from-rs-50-000-to-rs-10-lakh-per-year-11605139064519.html?fbclid=IwAR3PNdsXpiaDeN3WHkBgIwcvKKfJrBh-Kpin-RvaC8Nu_RhRHzXSZMilRAo,3,1,0,1,https://education/news/mbbs-fees-in-medical-colleges-raised-in-haryana-from-rs-50-000-to-rs-10-lakh-per-year-11605139064519.html?fbclid=IwAR3PNdsXpiaDeN3WHkBgIwcvKKfJrBh-Kpin-RvaC8Nu_RhRHzXSZMilRAo
461,https://https://www.livemint.com/photos/apple-event-highlights-in-pictures-1568143993788-3.html,3,2,0,2,https/www.livemint.com/photos/apple-event-highlights-in-pictures-1568143993788-3.html
462,https://industry/banking/central-bank-of-india-net-loss-narrows-to-rs-1-529-crore-in-q4/amp-11593430836570.html,3,3,1,2,https://industry/banking/central-bank-of-india-net-loss-narrows-to-rs-1-529-crore-in-q4/amp
463,https://industry/banking/page-8,3,2,0,2,industry/banking/page-8
464,https://industry/banking/treasury-income-to-support-banks-profitability-in-fiscal-2021-11592915824535.html,3,2,0,2,https://industry/banking/treasury-income-to-support-banks-profitability-in-fiscal-2021
465,https://industry/human-resource/sail-new-pension-scheme-current-former-employees/amp-1556684788108.html,3,3,1,2,industry/human-resource/sail-new-pension-scheme-current-former-employees/amp-1556684788108.html
466,https://industry/manufacturing/page-2,3,3,0,3,industry/manufacturing/page-2
467,https://industry/retail/amazon-india-expands-grocery-offering-to-new-cities-11604569151145.html,3,3,0,3,https://industry/retail/amazon-india-expands-grocery-offering-to-new-cities
468,https://industry/telecom/india-s-data-usage-per-smartphone-highest-in-world-at-9-8gb-per-month-report/amp-1560936943979.html,3,3,2,1,industry/telecom/india-s-data-usage-per-smartphone-highest-in-world-at-9-8gb-per-month-report/amp-1560936943979.html
469,https://insurance/news/test-story-budget-highlights-11579067382744.html,3,1,0,1,https://insurance/news/test-story-budget-highlights
470,https://market/commodities/gold-prices-today-rise-for-3rd-day-but-still-down-rs-5000-from-record-highs-11603249753696.html,3,2,0,2,https://market/commodities/gold-prices-today-rise-for-3rd-day-but-still-down-rs-5000-from-record-highs
471,https://market/mark-to-market/ambuja-cement-s-capacity-constraint-to-ease-but-cash-flow-may-become-a-concern-11603426062721.html,3,3,1,2,https://market/mark-to-market/ambuja-cement-s-capacity-constraint-to-ease-but-cash-flow-may-become-a-concern
472,https://market/mark-to-market/paints-margins-to-shine-as-crude-price-eases-volume-recovery-may-take-time/amp-1560273014136.html,3,1,0,1,market/mark-to-market/paints-margins-to-shine-as-crude-price-eases-volume-recovery-may-take-time/amp-1560273014136.html
473,https://market/market-stats/company-bse-tata-steel-ltd-100470,3,1,0,1,market/market-stats/company-bse-tata-steel-ltd-100470
474,https://market/stock-market-news/hindalco-up-3-after-novelis-closes-sale-of-former-aleris-plant-in-belgium-11601891837016.html,3,2,0,2,https://market/stock-market-news/hindalco-up-3-after-novelis-closes-sale-of-former-aleris-plant-in-belgium
475,https://market/stock-market-news/rupee-worst-performing-asian-currency-in-august-after-chinese-yuan-1567360543891.html,3,3,2,1,market/stock-market-news/rupee-worst-performing-asian-currency-in-august-after-chinese-yuan-1567360543891.html
476,https://market/stock-market-news/the-robinhood-craze-is-now-moving-stocks-everywhere-11596758345835.html,3,2,2,0,https://market/stock-market-news/the-robinhood-craze-is-now-moving-stocks-everywhere
477,https://mint-lounge/business-of-life/why-some-ceos-don-t-care-about-mbas-11578497893474.html,3,1,0,1,https://mint-lounge/business-of-life/why-some-ceos-don-t-care-about-mbas
478,https://mint-lounge/features/following-the-trail-of-the-ghee-roast-in-mangaluru-1554009932612.html,3,3,2,1,mint-lounge/features/following-the-trail-of-the-ghee-roast-in-mangaluru-1554009932612.html
479,https://mint-lounge/features/opinion-netflix-hotstar-or-amazon-1549603427357.html,3,1,0,1,mint-lounge/features/opinion-netflix-hotstar-or-amazon-1549603427357.html
480,https://mint-lounge/features/the-varied-aesthetics-of-the-indian-new-wave-1556867458268.html,3,3,3,0,mint-lounge/features/the-varied-aesthetics-of-the-indian-new-wave-1556867458268.html
481,https://money/ask-mint-money/property-buyer-needs-to-deduct-tds-if-seller-is-resident-of-india-in-relevant-fy-1553523127946.html,3,3,3,0,money/ask-mint-money/property-buyer-needs-to-deduct-tds-if-seller-is-resident-of-india-in-relevant-fy-1553523127946.html
482,https://money/personal-finance/can-i-claim-deduction-under-section-80gg-if-i-keep-my-flats-vacant/amp-11601178741036.html,3,3,2,1,https://money/personal-finance/can-i-claim-deduction-under-section-80gg-if-i-keep-my-flats-vacant/amp
483,https://money/personal-finance/gap-between-bank-fixed-deposits-and-small-savings-schemes-widens-11601531543278.html,3,3,1,2,https://money/personal-finance/gap-between-bank-fixed-deposits-and-small-savings-schemes-widens
484,https://money/personal-finance/income-tax-benefits-on-nps-new-rules-that-came-into-effect-this-year-11572522970447.html,3,2,1,1,https://money/personal-finance/income-tax-benefits-on-nps-new-rules-that-came-into-effect-this-year
485,https://money/personal-finance/log-in-to-get-insurance-without-medical-tests/amp-11586715070525.html,3,3,2,1,https://money/personal-finance/log-in-to-get-insurance-without-medical-tests/amp
486,https://money/personal-finance/ppf-sukanya-samriddhi-deposit-account-opening-eased-for-branch-post-offices/amp-11601885395981.html,3,3,2,1,https://money/personal-finance/ppf-sukanya-samriddhi-deposit-account-opening-eased-for-branch-post-offices/amp
487,https://money/personal-finance/sebi-bans-upfront-distributor-commissions-in-pms-introduces-direct-plans/amp-11581654805922.html,3,3,0,3,https://money/personal-finance/sebi-bans-upfront-distributor-commissions-in-pms-introduces-direct-plans/amp
488,https://money/personal-finance/three-regulation-changes-that-make-mutual-funds-safer-11602606084418.html,3,3,1,2,https://money/personal-finance/three-regulation-changes-that-make-mutual-funds-safer
489,https://mutual-fund/mf-news/bharat-bond-etf-10-things-to-know-about-india-s-first-corporate-bond-etf/amp-11575456164892.html,3,3,0,3,https://mutual-fund/mf-news/bharat-bond-etf-10-things-to-know-about-india-s-first-corporate-bond-etf/amp
490,https://mutual-fund/mf-news/you-can-register-sip-or-emi-e-mandate-based-on-debit-card-netbanking-details-1556094265686.html,3,3,2,1,mutual-fund/mf-news/you-can-register-sip-or-emi-e-mandate-based-on-debit-card-netbanking-details-1556094265686.html
491,https://news/india/28-new-coronavirus-cases-reported-in-jammu-and-kashmir-as-of-8-00-am-may-20/amp-11589945313347.html,3,3,3,0,https://news/india/28-new-coronavirus-cases-reported-in-jammu-and-kashmir-as-of-8-00-am-may-20/amp
492,https://news/india/air-india-express-flight-with-180-passengers-skids-on-runway-at-kozhikode-airport-11596813128851.html,3,3,0,3,https://news/india/air-india-express-flight-with-180-passengers-skids-on-runway-at-kozhikode-airport
493,https://news/india/babri-masjid-demolition-case-all-32-accused-including-lk-advani-acquitted-11601441403657.html,3,2,0,2,https://news/india/babri-masjid-demolition-case-all-32-accused-including-lk-advani-acquitted
494,https://news/india/centre-raises-excise-duty-on-petrol-by-rs-10-per-litre-and-on-diesel-by-rs-13-11588701701672.html,3,2,0,2,https://news/india/centre-raises-excise-duty-on-petrol-by-rs-10-per-litre-and-on-diesel-by-rs-13
495,https://news/india/coronavirus-lockdown-4-0-all-shops-can-open-but-with-staggered-timings-and-other-riders/amp-11589724998746.html,3,3,3,0,https://news/india/coronavirus-lockdown-4-0-all-shops-can-open-but-with-staggered-timings-and-other-riders/amp
496,https://news/india/covid-19-pm-modi-reviews-situation-with-cms-of-states-with-high-caseload/amp-11600866975964.html,3,3,1,2,https://news/india/covid-19-pm-modi-reviews-situation-with-cms-of-states-with-high-caseload/amp
497,https://news/india/delhi-hc-allows-vedanta-to-invoke-halliburton-advance-bank-guarantees-11590770437246.html,3,2,2,0,https://news/india/delhi-hc-allows-vedanta-to-invoke-halliburton-advance-bank-guarantees
498,https://news/india/drive-through-covid-19-testing-facility-launched-in-haryana-s-gurugram-11586657101308.html,3,3,2,1,https://news/india/drive-through-covid-19-testing-facility-launched-in-haryana-s-gurugram
499,https://news/india/frauds-rise-as-india-s-economy-slows-11575957308723.html,3,3,0,3,https://news/india/frauds-rise-as-india-s-economy-slows
