,urls,pageviews,users,new_users,returning_users,clean_url
0,https://companies/news/it-sector-hiring-in-new-age-skills-to-pick-up-in-2021/amp-11605686860932.html,16906,16137,3509,12628,https://companies/news/it-sector-hiring-in-new-age-skills-to-pick-up-in-2021/amp
1,https://market/commodities/gold-prices-today-fall-for-4th-day-in-row-silver-rates-slump-11605754985040.html,5052,4563,2090,2473,https://market/commodities/gold-prices-today-fall-for-4th-day-in-row-silver-rates-slump
2,https://market/stock-market-news/wall-street-us-stocks-decline-as-covid-19-cases-surge-jobless-claims-rise-11605801157893.html,2333,2170,33,2137,https://market/stock-market-news/wall-street-us-stocks-decline-as-covid-19-cases-surge-jobless-claims-rise
3,https://news/india/now-only-50-people-allowed-at-weddings-in-delhi-to-check-covid-19-surge/amp-11605687140134.html,1409,1307,424,883,https://news/india/now-only-50-people-allowed-at-weddings-in-delhi-to-check-covid-19-surge/amp
4,https://news/india/fall-in-exports-surge-in-inflation-puts-india-behind-em-peers/amp-11605684204641.html,954,887,111,776,https://news/india/fall-in-exports-surge-in-inflation-puts-india-behind-em-peers/amp
5,https://Epaper/M/Delhi/19/11/2020/Page/01,726,467,0,467,epaper/M/Delhi/19/11/2020/Page/01
7,https://market/market-stats/,514,363,27,336,market/market-stats
9,https://companies/news/govt-yet-to-decide-on-international-arbitration-appeal-in-voda-retro-tax-case/amp-11605611679333.html,352,336,94,242,https://companies/news/govt-yet-to-decide-on-international-arbitration-appeal-in-voda-retro-tax-case/amp
10,https://companies/news/dhfl-lenders-looking-to-repay-55-000-fd-holders-under-resolution-plan-11605609424712.html,305,231,68,163,https://companies/news/dhfl-lenders-looking-to-repay-55-000-fd-holders-under-resolution-plan
11,https://money/personal-finance/lvb-moratorium-things-that-depositors-shareholders-and-borrowers-need-to-know-11605693227416.html,279,226,70,156,https://money/personal-finance/lvb-moratorium-things-that-depositors-shareholders-and-borrowers-need-to-know
13,https://politics/news/loan-moratorium-sc-asks-power-producers-to-file-suggestions-on-relief-measures-11605779165730.html,232,212,78,134,https://politics/news/loan-moratorium-sc-asks-power-producers-to-file-suggestions-on-relief-measures
15,https://news/india/news-reports-of-indian-army-action-in-pok-fake-dgmo/amp-11605799021688.html,196,182,60,122,https://news/india/news-reports-of-indian-army-action-in-pok-fake-dgmo/amp
16,https://market/commodities/gold-prices-fall-rs-1000-in-minutes-after-pfizer-says-covid-vaccine-effective/amp-11604924687541.html,179,150,59,91,https://market/commodities/gold-prices-fall-rs-1000-in-minutes-after-pfizer-says-covid-vaccine-effective/amp
17,https://market/stock-market-news/nifty-edges-closer-to-13000-as-record-setting-rally-continues-what-analysts-say-11605699193572.html,165,140,26,114,https://market/stock-market-news/nifty-edges-closer-to-13000-as-record-setting-rally-continues-what-analysts-say
18,https://news/india/-saddened-by-the-accident-in-vadodara-pm-modi-expresses-grief-11605678609544.html,156,154,14,140,https://news/india/-saddened-by-the-accident-in-vadodara-pm-modi-expresses-grief
19,https://Epaper/M/Delhi/19/11/2020/Page/05,143,110,0,110,epaper/M/Delhi/19/11/2020/Page/05
20,https://market/stock-market-news/analysts-positive-on-consumption-sector-recommend-these-two-stocks/amp-11605749431595.html,133,129,7,122,https://market/stock-market-news/analysts-positive-on-consumption-sector-recommend-these-two-stocks/amp
21,https://news/india/mbbs-courses-kerala-to-move-supreme-court-against-high-fee-structure/amp-11605762678745.html,124,120,27,93,https://news/india/mbbs-courses-kerala-to-move-supreme-court-against-high-fee-structure/amp
23,https://news/india/-public-health-spending-should-go-up-to-2-5-of-gdp-by-2024-11605756413154.html,108,99,24,75,https://news/india/-public-health-spending-should-go-up-to-2-5-of-gdp-by-2024
24,https://brand-stories/intelligent-pcs-that-learn-from-you-11603190211969.html,102,76,15,61,https://brand-stories/intelligent-pcs-that-learn-from-you
25,https://news/world/china-detects-covid-19-on-frozen-beef-shrimp-from-various-countries-sounds-alarm-11605418815448.html,97,80,37,43,https://news/world/china-detects-covid-19-on-frozen-beef-shrimp-from-various-countries-sounds-alarm
26,https://news/world/to-help-economy-bank-proposes-5-tax-for-employees-working-from-home/amp-11605202587063.html,93,85,26,59,https://news/world/to-help-economy-bank-proposes-5-tax-for-employees-working-from-home/amp
28,https://news/india/registration-of-construction-worker-through-door-step-delivery-in-delhi-manish-sisodia-11605773319764.html,85,75,8,67,https://news/india/registration-of-construction-worker-through-door-step-delivery-in-delhi-manish-sisodia
30,https://Object/o6mURyu9oxYAJoovrnFH1M/subscribe.html,77,62,24,38,object/o6mURyu9oxYAJoovrnFH1M/subscribe.html
31,https://news/india/india-ranks-77-in-global-bribery-risk-matrix-11605785059833.html,74,57,15,42,https://news/india/india-ranks-77-in-global-bribery-risk-matrix
32,https://market/stock-market-news/here-are-the-top-10-highest-dividend-paying-stocks/amp-11598589134087.html,71,61,30,31,https://market/stock-market-news/here-are-the-top-10-highest-dividend-paying-stocks/amp
34,https://market/stock-market-news/-keep-the-faith-morgan-stanley-has-a-positive-outlook-for-stocks-for-next-year-11605498738433.html,66,51,9,42,https://market/stock-market-news/-keep-the-faith-morgan-stanley-has-a-positive-outlook-for-stocks-for-next-year
35,https://news/india/un-report-cites-isro-efforts-in-assisting-indian-government-to-contain-covid-19-11605767545096.html,64,57,17,40,https://news/india/un-report-cites-isro-efforts-in-assisting-indian-government-to-contain-covid-19
37,https://news/world/elon-musk-is-just-a-tesla-inc-rally-away-becoming-world-s-second-richest/amp-11605759781566.html,59,57,10,47,https://news/world/elon-musk-is-just-a-tesla-inc-rally-away-becoming-world-s-second-richest/amp
38,https://news/world/china-all-set-to-change-its-development-model-from-2021-xi-11605786929992.html,57,49,9,40,https://news/world/china-all-set-to-change-its-development-model-from-2021-xi
39,https://Home/MShareArticle?OrgId=1911ab35f599&imageview=0,54,48,0,48,home/MShareArticle?OrgId=1911ab35f599&imageview=0
44,https://money/personal-finance/nhai-rec-cut-interest-on-capital-gains-bonds/amp-11596365448526.html,48,46,12,34,https://money/personal-finance/nhai-rec-cut-interest-on-capital-gains-bonds/amp
45,https://money/personal-finance/what-happens-if-you-don-t-file-income-tax-return-itr-penalty-or-even-jail/amp-11597290432835.html,47,46,21,25,https://money/personal-finance/what-happens-if-you-don-t-file-income-tax-return-itr-penalty-or-even-jail/amp
47,https://news/india/indian-economy-will-see-double-digit-growth-next-fiscal-virmani-11605709306698.html,45,37,8,29,https://news/india/indian-economy-will-see-double-digit-growth-next-fiscal-virmani
48,https://news/india/validity-of-driving-licences-and-motor-vehicle-documents-extended-till-31-dec/amp-11598266399172.html,44,39,18,21,https://news/india/validity-of-driving-licences-and-motor-vehicle-documents-extended-till-31-dec/amp
55,https://money/ask-mint-money,37,32,3,29,money/ask-mint-money
56,https://companies/news/fidelity-renews-300-000-sq-ft-office-space-in-xander-s-bengaluru-property/amp-11605784876912.html,36,34,13,21,https://companies/news/fidelity-renews-300-000-sq-ft-office-space-in-xander-s-bengaluru-property/amp
57,https://science/health/decoded-how-smoking-worsens-coronavirus-infection/amp-11605754426566.html,36,33,15,18,https://science/health/decoded-how-smoking-worsens-coronavirus-infection/amp
62,https://money/personal-finance/epf-withdrawal-rules-when-can-you-partially-withdraw-your-pf-money/amp-1559903682006.html,32,28,11,17,money/personal-finance/epf-withdrawal-rules-when-can-you-partially-withdraw-your-pf-money/amp-1559903682006.html
72,https://technology/apps/whatsapp-gets-a-new-shopping-button-how-it-works-11605010824029.html,27,11,3,8,https://technology/apps/whatsapp-gets-a-new-shopping-button-how-it-works
76,https://mutual-fund/mf-news/10-favourite-stocks-of-mutual-funds/amp-11595053646939.html,25,21,4,17,https://mutual-fund/mf-news/10-favourite-stocks-of-mutual-funds/amp
80,https://market/market-stats/bse-top-losers,23,18,1,17,market/market-stats/bse-top-losers
86,https://money/personal-finance/with-11-returns-nps-tier-ii-outshines-bank-fds-liquid-funds-11600847170287.html,21,20,7,13,https://money/personal-finance/with-11-returns-nps-tier-ii-outshines-bank-fds-liquid-funds
88,https://companies/bharat-petroleum-privatisation-govt-to-provide-rules-on-employee-protection-asset-stripping-later/amp-11599389747900.html,20,19,9,10,https://companies/bharat-petroleum-privatisation-govt-to-provide-rules-on-employee-protection-asset-stripping-later/amp
94,https://news/india/india-china-agree-on-three-step-disengagement-plan-from-pangong-lake-area-11605079654893.html,19,11,1,10,https://news/india/india-china-agree-on-three-step-disengagement-plan-from-pangong-lake-area
98,https://news/india/india-s-active-covid-cases-drop-closer-to-5-lakh-as-recoveries-outpace-new-case-11604894476053.html,18,3,0,3,https://news/india/india-s-active-covid-cases-drop-closer-to-5-lakh-as-recoveries-outpace-new-case
101,https://industry/banking/indian-banks-are-in-for-a-20-trillion-hole/amp-11594908292074.html,17,16,5,11,https://industry/banking/indian-banks-are-in-for-a-20-trillion-hole/amp
103,https://news/india/page-4,17,14,0,14,news/india/page-4
104,https://topic/debt-funds,17,12,1,11,topic/debt-funds
107,https://money/personal-finance/now-paytm-users-have-to-pay-2-charge-on-using-credit-cards-to-top-up-wallets-11602944126802.html,16,16,6,10,https://money/personal-finance/now-paytm-users-have-to-pay-2-charge-on-using-credit-cards-to-top-up-wallets
109,https://news/world/obama-says-us-adversaries-already-see-a-weakened-country-11605489161301.html,16,13,3,10,https://news/world/obama-says-us-adversaries-already-see-a-weakened-country
110,https://Home/ShareArticle?OrgId=1911d64116fb&imageview=0,15,15,0,15,home/ShareArticle?OrgId=1911d64116fb&imageview=0
112,https://market/commodities/gold-prices-today-higher-but-down-rs-5-000-from-record-highs-silver-rates-surge/amp-11603767598670.html,15,10,4,6,https://market/commodities/gold-prices-today-higher-but-down-rs-5-000-from-record-highs-silver-rates-surge/amp
113,https://money/personal-finance/nps-tier-ii-account-income-tax-benefits-rules-for-govt-employees-released/amp-11597908437590.html,15,13,4,9,https://money/personal-finance/nps-tier-ii-account-income-tax-benefits-rules-for-govt-employees-released/amp
114,https://news/india/how-fraudsters-are-using-fake-ids-to-travel-in-mumbai-local-train/amp-11601967219022.html,15,15,7,8,https://news/india/how-fraudsters-are-using-fake-ids-to-travel-in-mumbai-local-train/amp
121,https://news/india/maharashtra-stamp-duty-cut-to-encourage-fence-sitters-in-making-purchase-decisions-say-realtors/amp-11598788211886.html,14,14,6,8,https://news/india/maharashtra-stamp-duty-cut-to-encourage-fence-sitters-in-making-purchase-decisions-say-realtors/amp
122,https://politics/news/mallikarjun-kharge-hits-out-at-those-weakening-cong-from-within-by-attacking-leadership/amp-11605795925148.html,14,12,2,10,https://politics/news/mallikarjun-kharge-hits-out-at-those-weakening-cong-from-within-by-attacking-leadership/amp
123,https://Epaper/M/Delhi/18/11/2020/Page/02,13,8,0,8,epaper/M/Delhi/18/11/2020/Page/02
125,https://companies/news/ril-to-invest-up-to-50-mn-in-bill-gates-owned-breakthrough-energy-ventures/amp-11605195386475.html,13,11,3,8,https://companies/news/ril-to-invest-up-to-50-mn-in-bill-gates-owned-breakthrough-energy-ventures/amp
126,https://industry/telecom/travelling-abroad-airtel-revises-international-roaming-packs-details-here/amp-11582698431841.html,13,13,4,9,https://industry/telecom/travelling-abroad-airtel-revises-international-roaming-packs-details-here/amp
127,https://money/personal-finance/gold-taxation-how-gold-jewellery-digital-gold-sovereign-gold-bonds-are-taxed-11598059614958.html,13,13,5,8,https://money/personal-finance/gold-taxation-how-gold-jewellery-digital-gold-sovereign-gold-bonds-are-taxed
128,https://mutual-fund/mf-news/what-happens-when-you-miss-sip-payment/amp-11598058006578.html,13,13,5,8,https://mutual-fund/mf-news/what-happens-when-you-miss-sip-payment/amp
130,https://news/world/ukraine-s-health-minister-tests-positive-for-covid-19-as-cases-rise-11605402155762.html,13,11,1,10,https://news/world/ukraine-s-health-minister-tests-positive-for-covid-19-as-cases-rise
131,https://topic/amp-npa,13,11,5,6,topic/amp-npa
133,https://Search/Link/Author/Amit-Panday,12,9,1,8,search/Link/Author/Amit-Panday
134,https://companies/news/india-s-online-video-market-to-touch-4-billion-by-2025-11589795634495.html,12,10,2,8,https://companies/news/india-s-online-video-market-to-touch-4-billion-by-2025
137,https://money/personal-finance/ppf-account-why-investors-should-be-aware-of-form-h-11571225519404.html,12,10,3,7,https://money/personal-finance/ppf-account-why-investors-should-be-aware-of-form-h
139,https://news/india/pli-scheme-might-lead-to-new-investments-in-auto-sector-say-industry-experts/amp-11605105484530.html,12,10,2,8,https://news/india/pli-scheme-might-lead-to-new-investments-in-auto-sector-say-industry-experts/amp
140,https://opinion/columns/the-trojan-horse-of-a-trade-pact-that-india-should-guard-against/amp-11572788673795.html?__twitter_impression=true,12,9,4,5,https://opinion/columns/the-trojan-horse-of-a-trade-pact-that-india-should-guard-against/amp-11572788673795.html?__twitter_impression=true
145,https://industry/retail/festivals-bring-some-respite-for-apparel-retailers/amp-11605783606044.html,11,11,3,8,https://industry/retail/festivals-bring-some-respite-for-apparel-retailers/amp
148,https://news/india/centre-announces-10-000-cr-boost-for-rural-economy-11605237685076.html,11,5,0,5,https://news/india/centre-announces-10-000-cr-boost-for-rural-economy
151,https://politics/news/bihar-govt-formation-nitish-kumar-named-as-the-next-bihar-chief-minister/amp-11605426836471.html,11,11,5,6,https://politics/news/bihar-govt-formation-nitish-kumar-named-as-the-next-bihar-chief-minister/amp
152,https://Epaper/M/Mumbai/19/11/2020/Page/13,10,10,0,10,epaper/M/Mumbai/19/11/2020/Page/13
155,https://companies/news/bigbasket-faces-data-breach-details-of-2-crore-users-put-on-sale-on-dark-web/amp-11604794339735.html,10,10,4,6,https://companies/news/bigbasket-faces-data-breach-details-of-2-crore-users-put-on-sale-on-dark-web/amp
157,https://leisure/dpyd8ophqcqfz6cdnorzji/cdn.knightlab.com/libs/juxtapose/latest/embed/index.html,10,1,0,1,leisure/dpyd8ophqcqfz6cdnorzji/cdn.knightlab.com/libs/juxtapose/latest/embed/index.html
158,https://money/ask-mint-money/an-ancestral-property-becomes-self-acquired-if-it-is-partitioned-11591723196099.html,10,10,4,6,https://money/ask-mint-money/an-ancestral-property-becomes-self-acquired-if-it-is-partitioned
159,https://money/personal-finance/mutual-fund-apps-that-can-help-you-invest-from-home-11588065573073.html,10,10,3,7,https://money/personal-finance/mutual-fund-apps-that-can-help-you-invest-from-home
161,https://news/india/high-food-prices-at-heart-of-india-s-inflation-problem-11603988429841.html,10,10,2,8,https://news/india/high-food-prices-at-heart-of-india-s-inflation-problem
162,https://news/india/pensioners-can-store-pension-payment-order-ppo-in-digilocker-here-is-how-11598488458595.html,10,7,2,5,https://news/india/pensioners-can-store-pension-payment-order-ppo-in-digilocker-here-is-how
163,https://news/world/china-targets-frozen-food-imports-over-coronavirus-fears-11605676723646.html,10,10,3,7,https://news/world/china-targets-frozen-food-imports-over-coronavirus-fears
182,https://Epaper/Delhi/16/11/2020/Page/01: front,8,8,0,8,epaper/Delhi/16/11/2020/Page/01:%20front
184,https://Money/lAoDltWB3BFwQRdz7UhyTK/Investing-in-Gsecs-becomes-simpler-should-you-buy.html?facet=amp,8,4,1,3,money/lAoDltWB3BFwQRdz7UhyTK/Investing-in-Gsecs-becomes-simpler-should-you-buy.html?facet=amp
186,https://Technology/aut4lb3oGkqrc4ZGgDoerO/8-ways-to-spot-fake-news.html?facet=amp,8,6,2,4,technology/aut4lb3oGkqrc4ZGgDoerO/8-ways-to-spot-fake-news.html?facet=amp
190,https://industry/telecom/pli-for-telecom-sector-to-encourage-indian-global-firms-ravi-shankar-prasad-11605108990257.html,8,6,1,5,https://industry/telecom/pli-for-telecom-sector-to-encourage-indian-global-firms-ravi-shankar-prasad
191,https://market/stock-market-news/markets-are-already-pricing-a-successful-moderna-vaccine-shot/amp-11605280591780.html,8,8,1,7,https://market/stock-market-news/markets-are-already-pricing-a-successful-moderna-vaccine-shot/amp
193,https://money/personal-finance/new-income-tax-slab-rate-you-might-not-need-a-ca-to-file-income-tax-return-itr-11580797305014.html,8,8,3,5,https://money/personal-finance/new-income-tax-slab-rate-you-might-not-need-a-ca-to-file-income-tax-return-itr
195,https://news/india/bharti-infratel-board-approves-merger-with-indus-towers/amp-11598930434341.html,8,7,3,4,https://news/india/bharti-infratel-board-approves-merger-with-indus-towers/amp
199,https://opinion/online-views/india-should-use-this-economic-crisis-to-implement-reforms-3-0-11603728986754.html,8,8,0,8,https://opinion/online-views/india-should-use-this-economic-crisis-to-implement-reforms-3-0
201,https://Companies/boSuroFjWnoZq4yvly0itO/Can-CSR-funds-make-a-difference-in-healthcare.html,7,5,1,4,companies/boSuroFjWnoZq4yvly0itO/Can-CSR-funds-make-a-difference-in-healthcare.html
202,https://Epaper/M/Delhi/18/11/2020/Page/09,7,5,0,5,epaper/M/Delhi/18/11/2020/Page/09
205,https://Money/vGwO6ejDP4PKIPTAEP9CLP/Four-ways-to-check-whether-property-is-legal.html,7,7,2,5,money/vGwO6ejDP4PKIPTAEP9CLP/Four-ways-to-check-whether-property-is-legal.html
208,https://companies/company-results/reliance-jio-net-profit-jumps-183-to-rs-2-520-crore-in-q1/amp-11596102630222.html,7,7,2,5,https://companies/company-results/reliance-jio-net-profit-jumps-183-to-rs-2-520-crore-in-q1/amp
210,https://companies/news/tcs-in-talks-to-buy-deutsche-bank-s-technology-unit/amp-11603343464817.html,7,7,2,5,https://companies/news/tcs-in-talks-to-buy-deutsche-bank-s-technology-unit/amp
211,https://companies/start-ups/the-unraveling-of-shopclues-from-unicorn-to-also-ran-11572756549494.html,7,5,1,4,https://companies/start-ups/the-unraveling-of-shopclues-from-unicorn-to-also-ran
212,https://industry/banking/mpokket-to-disburse-instant-loans-of-rs-1-200-cr-this-fiscal-11600691162210.html,7,7,1,6,https://industry/banking/mpokket-to-disburse-instant-loans-of-rs-1-200-cr-this-fiscal
214,https://market/ipo/uti-amc-shares-list-at-a-discount-as-compared-to-issue-price-11602475808347.html,7,6,1,5,https://market/ipo/uti-amc-shares-list-at-a-discount-as-compared-to-issue-price
215,https://market/stock-market-news/stocks-to-watch-ril-lakshmi-vilas-bank-mindtree-dr-reddy-s-sun-pharma-ceat-11601259499312.html,7,3,0,3,https://market/stock-market-news/stocks-to-watch-ril-lakshmi-vilas-bank-mindtree-dr-reddy-s-sun-pharma-ceat
220,https://news/india/delhi-govt-has-no-money-to-pay-salaries-writes-to-centre-for-rs5-000-crore-11590917422950.html,7,5,1,4,https://news/india/delhi-govt-has-no-money-to-pay-salaries-writes-to-centre-for-rs5-000-crore
224,https://news/india/why-antitrust-is-a-jumbo-indian-problem-11596375452543.html,7,4,1,3,https://news/india/why-antitrust-is-a-jumbo-indian-problem
227,https://technology/tech-news/sony-microsoft-consoles-struggle-with-thin-launch-day-stock/amp-11605759717588.html,7,7,2,5,https://technology/tech-news/sony-microsoft-consoles-struggle-with-thin-launch-day-stock/amp
229,https://Epaper/Delhi/17/11/2020/Page/08: top stories,6,6,0,6,epaper/Delhi/17/11/2020/Page/08:%20top%20stories
232,https://Money/KVpRnmlznCLrqssriFnZdL/You-cannot-draw-on-provident-fund-to-pay-a-personal-loan.html,6,5,2,3,money/KVpRnmlznCLrqssriFnZdL/You-cannot-draw-on-provident-fund-to-pay-a-personal-loan.html
235,https://Search/Link/Author/Rahul-Jacob,6,6,0,6,search/Link/Author/Rahul-Jacob
237,https://companies/company-results/hal-s-q2-net-profit-decreases-marginally-to-rs-615-cr/amp-11605262481364.html,6,6,2,4,https://companies/company-results/hal-s-q2-net-profit-decreases-marginally-to-rs-615-cr/amp
238,https://companies/news/digital-platforms-shine-spotlight-on-small-medium-biz-11605231496404.html,6,6,1,5,https://companies/news/digital-platforms-shine-spotlight-on-small-medium-biz
239,https://companies/news/meteor-350-aimed-at-pulling-customers-from-other-brands-sid-lal-11605193221741.html,6,5,0,5,https://companies/news/meteor-350-aimed-at-pulling-customers-from-other-brands-sid-lal
241,https://companies/people/we-never-told-the-coronil-can-cure-or-control-corona-patanjali-ceo-acharya-balkrishna/amp-11593514785834.html,6,6,2,4,https://companies/people/we-never-told-the-coronil-can-cure-or-control-corona-patanjali-ceo-acharya-balkrishna/amp
245,https://market/stock-market-news/govt-s-divestment-efforts-may-get-a-15-000-cr-boost-11601865784809.html,6,6,1,5,https://market/stock-market-news/govt-s-divestment-efforts-may-get-a-15-000-cr-boost
247,https://money/personal-finance/contribution-to-eps-is-not-payable-from-employee-s-pf-share/amp-11595526174923.html,6,5,2,3,https://money/personal-finance/contribution-to-eps-is-not-payable-from-employee-s-pf-share/amp
248,https://money/personal-finance/income-tax-officers-suggest-40-tax-on-super-rich-covid-relief-cess-11587894341797.html,6,5,2,3,https://money/personal-finance/income-tax-officers-suggest-40-tax-on-super-rich-covid-relief-cess
249,https://money/personal-finance/sbi-revises-fixed-deposit-fd-interest-rates-check-latest-rates-here-11570599090824.html,6,3,1,2,https://money/personal-finance/sbi-revises-fixed-deposit-fd-interest-rates-check-latest-rates-here
250,https://news/delhi-govt-provided-over-60-000-oximeters-to-covid-19-patients-data/amp-11601217980428.html,6,5,2,3,https://news/delhi-govt-provided-over-60-000-oximeters-to-covid-19-patients-data/amp
251,https://news/india/bengaluru-metro-train-network-to-be-extended-check-new-routes/amp-11573174168643.html,6,5,2,3,https://news/india/bengaluru-metro-train-network-to-be-extended-check-new-routes/amp
252,https://news/india/defence-ministry-withdraws-order-on-income-tax-deduction-from-disability-pension-11583247710845.html,6,6,2,4,https://news/india/defence-ministry-withdraws-order-on-income-tax-deduction-from-disability-pension
253,https://news/india/govt-relaxes-visa-rules-oci-and-pio-card-holders-can-visit-india-11603352892070.html,6,4,1,3,https://news/india/govt-relaxes-visa-rules-oci-and-pio-card-holders-can-visit-india
258,https://news/world/us-fda-authorizes-first-covid-19-test-for-self-testing-at-home-11605668508702.html,6,6,1,5,https://news/world/us-fda-authorizes-first-covid-19-test-for-self-testing-at-home
264,https://Consumer/vj5e3v3uGyQR9KRwcvNBvN/Millennials-to-redefine-Indias-consumption-story-report.html,5,4,1,3,consumer/vj5e3v3uGyQR9KRwcvNBvN/Millennials-to-redefine-Indias-consumption-story-report.html
265,https://Home/MShareImage?Pictureid=19118b8330fb,5,5,0,5,home/MShareImage?Pictureid=19118b8330fb
268,https://Money/78YOwFK3k4HVt32iCqx5QO/Monthly-family-pension-is-exempt-under-certain-circumstances.html?facet=amp,5,3,1,2,money/78YOwFK3k4HVt32iCqx5QO/Monthly-family-pension-is-exempt-under-certain-circumstances.html?facet=amp
271,https://Opinion/K7BtzvPYmyO0KlDn21iixH/How-to-break-the-back-of-Indias-Leftwing-ecosystem.html,5,5,2,3,opinion/K7BtzvPYmyO0KlDn21iixH/How-to-break-the-back-of-Indias-Leftwing-ecosystem.html
273,https://Politics/gx6Uh1sl0uEgCY1tGHUuPI/Bank-account-details-not-in-RTI-ambit.html?facet=amp,5,5,2,3,politics/gx6Uh1sl0uEgCY1tGHUuPI/Bank-account-details-not-in-RTI-ambit.html?facet=amp
274,https://Search/Link/Author/Shubham-Ladha,5,4,1,3,search/Link/Author/Shubham-Ladha
276,https://brand-post/invest-in-companies-before-they-launch-their-ipos/amp-11587472378958.html,5,4,1,3,https://brand-post/invest-in-companies-before-they-launch-their-ipos/amp
277,https://companies/cost-cutting-bears-fruit-for-auto-firms/amp-11605233837398.html,5,5,0,5,https://companies/cost-cutting-bears-fruit-for-auto-firms/amp
287,https://insurance/news/a-perfect-gift-for-your-family-this-festive-season/amp-11605313454292.html,5,5,2,3,https://insurance/news/a-perfect-gift-for-your-family-this-festive-season/amp
289,https://market/stock-market-news/morgan-stanley-s-ridham-desai-says-indian-markets-attractive-likes-mid-caps/amp-11602834157399.html,5,5,2,3,https://market/stock-market-news/morgan-stanley-s-ridham-desai-says-indian-markets-attractive-likes-mid-caps/amp
291,https://money/ask-mint-money/during-the-limitation-period-legal-heirs-can-object-to-asset-transfer-1568127638170.html,5,3,1,2,money/ask-mint-money/during-the-limitation-period-legal-heirs-can-object-to-asset-transfer-1568127638170.html
293,https://money/personal-finance/india-post-payments-bank-ippb-rolls-out-of-aadhaar-enabled-payment-services-aeps-10-things-to-know/amp-1568024793422.html,5,4,0,4,money/personal-finance/india-post-payments-bank-ippb-rolls-out-of-aadhaar-enabled-payment-services-aeps-10-things-to-know/amp-1568024793422.html
294,https://money/personal-finance/pan-aadhaar-linking-deadline-september-30-failure-name-mismatch/amp-1569493056484.html,5,3,1,2,money/personal-finance/pan-aadhaar-linking-deadline-september-30-failure-name-mismatch/amp-1569493056484.html
296,https://mutual-fund/mf-news/neelesh-surana-of-mirae-asset-shares-covid-proof-mutual-fund-investment-strategy/amp-11599612463892.html,5,4,1,3,https://mutual-fund/mf-news/neelesh-surana-of-mirae-asset-shares-covid-proof-mutual-fund-investment-strategy/amp
297,https://news/india/adani-group-set-to-develop-sri-lanka-s-east-container-terminal-in-colombo-port-11604395943597.html,5,3,1,2,https://news/india/adani-group-set-to-develop-sri-lanka-s-east-container-terminal-in-colombo-port
298,https://news/india/coronavirus-cases-rise-the-most-in-west-bengal-ahead-of-durga-puja-11603350262444.html,5,5,2,3,https://news/india/coronavirus-cases-rise-the-most-in-west-bengal-ahead-of-durga-puja
300,https://news/india/haryana-issues-new-guidelines-for-home-isolation-care-of-covid-19-patients/amp-11600487182443.html,5,5,1,4,https://news/india/haryana-issues-new-guidelines-for-home-isolation-care-of-covid-19-patients/amp
301,https://news/india/india-s-vaccine-production-capacity-to-help-humanity-in-fight-against-covid-pm-11601129085566.html,5,5,2,3,https://news/india/india-s-vaccine-production-capacity-to-help-humanity-in-fight-against-covid-pm
303,https://news/india/npci-launches-international-arm-for-adoption-of-upi-rupay-in-other-countries-11597846171558.html,5,4,1,3,https://news/india/npci-launches-international-arm-for-adoption-of-upi-rupay-in-other-countries
307,https://news/world/uk-study-finds-cellular-immunity-in-non-hospitalised-covid-cases-at-6-months-11604383001192.html,5,4,0,4,https://news/world/uk-study-finds-cellular-immunity-in-non-hospitalised-covid-cases-at-6-months
308,https://opinion/online-views/india-needs-an-open-capital-account-by-2025/amp-11599303164180.html,5,3,1,2,https://opinion/online-views/india-needs-an-open-capital-account-by-2025/amp
309,https://politics/policy/nhb-tightens-norms-on-hfcs-leverage-and-capital-adequacy-ratios-1561051669685.html,5,4,1,3,politics/policy/nhb-tightens-norms-on-hfcs-leverage-and-capital-adequacy-ratios-1561051669685.html
312,https://topic/vodafone-idea,5,4,1,3,topic/vodafone-idea
314,https://Companies/W1KcASuM6q2liXL3ALmJRJ/Bajaj-Group-plans-for-Gen-Next-with-a-family-settlement.html,4,3,0,3,companies/W1KcASuM6q2liXL3ALmJRJ/Bajaj-Group-plans-for-Gen-Next-with-a-family-settlement.html
315,https://Companies/z4Q2wkDfcUNq4uPsdyxAPP/PG-plans-to-eliminate-100-brands-to-focus-on-top-performers.html,4,1,0,1,companies/z4Q2wkDfcUNq4uPsdyxAPP/PG-plans-to-eliminate-100-brands-to-focus-on-top-performers.html
316,https://Epaper/M/Delhi/17/11/2020/Page/09,4,2,0,2,epaper/M/Delhi/17/11/2020/Page/09
317,https://Home/MShareImage?Pictureid=19111236aa1d,4,4,0,4,home/MShareImage?Pictureid=19111236aa1d
323,https://Money/BnwoF7nQJfFA4llR9ktkFL/What-you-need-to-know-before-taking-an-education-loan.html?facet=amp,4,4,1,3,money/BnwoF7nQJfFA4llR9ktkFL/What-you-need-to-know-before-taking-an-education-loan.html?facet=amp
325,https://Money/ihlm1NpnA3yZpbBHUnNxHP/Shortterm-capital-gains-tax-applies-if-you-sell-the-shares.html?facet=amp,4,3,1,2,money/ihlm1NpnA3yZpbBHUnNxHP/Shortterm-capital-gains-tax-applies-if-you-sell-the-shares.html?facet=amp
326,https://Multimedia/Nl2thJvsNbktoiHCIpPh8J/Chacha-Nehru-and-his-furry-friends.html?facet=amp,4,3,0,3,multimedia/Nl2thJvsNbktoiHCIpPh8J/Chacha-Nehru-and-his-furry-friends.html?facet=amp
329,https://Politics/5HU9KriaUIbYUaPdvdvtsO/www.thinglink.com/card/www.thinglink.com/card/www.thinglink.com/card/www.thinglink.com/card/www.thinglink.com/card/611491258145177600,4,3,0,3,politics/5HU9KriaUIbYUaPdvdvtsO/www.thinglink.com/card/www.thinglink.com/card/www.thinglink.com/card/www.thinglink.com/card/www.thinglink.com/card/611491258145177600
330,https://Politics/5HU9KriaUIbYUaPdvdvtsO/www.thinglink.com/card/www.thinglink.com/card/www.thinglink.com/card/www.thinglink.com/card/www.thinglink.com/card/www.thinglink.com/card/www.thinglink.com/card/www.thinglink.com/card/www.thinglink.com/card/www.thinglink.com/card/www.thinglink.com/card/www.thinglink.com/card/www.thinglink.com/card/www.thinglink.com/card/www.thinglink.com/card/www.thinglink.com/card/www.thinglink.com/card/www.thinglink.com/card/www.thinglink.com/card/www.thinglink.com/card/www.thinglink.com/card/www.thinglink.com/card/www.thinglink.com/card/www.thinglink.com/card/www.thinglink.com/card/www.thinglink.com/card/www.thinglink.com/card/www.thinglink.com/card/www.thinglink.com/card/www.thinglink.com/card/www.thinglink.com/card/www.thinglink.com/card/www.thinglink.com/card/www.thinglink.com/card/www.thinglink.com/card/www.thinglink.com/card/www.thinglink.com/card/www.thinglink.com/card/www.thinglink.com/card/www.thinglink.com/card/www.thinglink.com/card/www.thinglink.com/card/www.thinglink.com/card/www.thinglink.com/card/www.thinglink.com/card/www.thinglink.com/card/www.thinglink.com/card/www.thinglink.com/card/www.thinglink.com/card/www.thinglink.com/card/www.thinglink.com/card/www.thinglink.com/card/www.thinglink.com/card/www.thinglink.com/card/www.thinglink.com/card/www.thinglink.com/card/www.thinglink.com/card/611491258145177600,4,3,0,3,politics/5HU9KriaUIbYUaPdvdvtsO/www.thinglink.com/card/www.thinglink.com/card/www.thinglink.com/card/www.thinglink.com/card/www.thinglink.com/card/www.thinglink.com/card/www.thinglink.com/card/www.thinglink.com/card/www.thinglink.com/card/www.thinglink.com/card/www.thinglink.com/card/www.thinglink.com/card/www.thinglink.com/card/www.thinglink.com/card/www.thinglink.com/card/www.thinglink.com/card/www.thinglink.com/card/www.thinglink.com/card/www.thinglink.com/card/www.thinglink.com/card/www.thinglink.com/card/www.thinglink.com/card/www.thinglink.com/card/www.thinglink.com/card/www.thinglink.com/card/www.thinglink.com/card/www.thinglink.com/card/www.thinglink.com/card/www.thinglink.com/card/www.thinglink.com/card/www.thinglink.com/card/www.thinglink.com/card/www.thinglink.com/card/www.thinglink.com/card/www.thinglink.com/card/www.thinglink.com/card/www.thinglink.com/card/www.thinglink.com/card/www.thinglink.com/card/www.thinglink.com/card/www.thinglink.com/card/www.thinglink.com/card/www.thinglink.com/card/www.thinglink.com/card/www.thinglink.com/card/www.thinglink.com/card/www.thinglink.com/card/www.thinglink.com/card/www.thinglink.com/card/www.thinglink.com/card/www.thinglink.com/card/www.thinglink.com/card/www.thinglink.com/card/www.thinglink.com/card/www.thinglink.com/card/www.thinglink.com/card/www.thinglink.com/card/611491258145177600
334,https://Search/Link/Keyword/India-Investment,4,4,1,3,search/Link/Keyword/India-Investment
335,https://Search/Link/Keyword/loan-moratorium,4,3,0,3,search/Link/Keyword/loan-moratorium
338,https://brand-stories/how-does-the-workplace-of-the-future-look-like-11584713699808.html,4,3,0,3,https://brand-stories/how-does-the-workplace-of-the-future-look-like
339,https://companies/news/adani-power-board-approves-rs-3-264-crore-delisting-plan/amp-11592829821565.html,4,4,0,4,https://companies/news/adani-power-board-approves-rs-3-264-crore-delisting-plan/amp
341,https://companies/news/dr-reddy-s-gets-dcgi-nod-to-conduct-clinical-trial-for-sputnik-v-vaccine-in-india-11602932255342.html,4,4,1,3,https://companies/news/dr-reddy-s-gets-dcgi-nod-to-conduct-clinical-trial-for-sputnik-v-vaccine-in-india
344,https://companies/news/ril-appoints-former-indian-oil-chairman-sanjiv-singh-as-group-president/amp-11598437071251.html,4,4,1,3,https://companies/news/ril-appoints-former-indian-oil-chairman-sanjiv-singh-as-group-president/amp
345,https://companies/news/uncertainty-over-fds-in-dhfl-s-resolution/amp-11605056419960.html,4,4,1,3,https://companies/news/uncertainty-over-fds-in-dhfl-s-resolution/amp
347,https://companies/start-ups/deepika-padukone-invests-in-maker-of-epigamia-yogurt/amp-1557771851043.html,4,4,1,3,companies/start-ups/deepika-padukone-invests-in-maker-of-epigamia-yogurt/amp-1557771851043.html
350,https://industry/banking/loan-defaults-hit-nbfcs-fintech-firms-the-hardest/amp-11605574486543.html?__twitter_impression=true&s=09,4,4,1,3,https://industry/banking/loan-defaults-hit-nbfcs-fintech-firms-the-hardest/amp-11605574486543.html?__twitter_impression=true&s=09
351,https://industry/energy/govt-cuts-gas-price-by-25-to-lowest-on-record/amp-11601472586101.html,4,3,0,3,https://industry/energy/govt-cuts-gas-price-by-25-to-lowest-on-record/amp
355,https://market/ipo/shanghai-stock-exchange-suspends-ant-group-s-a-share-ipo/amp-11604412338257.html,4,3,1,2,https://market/ipo/shanghai-stock-exchange-suspends-ant-group-s-a-share-ipo/amp
356,https://market/mark-to-market/sbi-life-delivers-on-growth-metrics-but-profitability-underwhelms-11603773813425.html,4,4,0,4,https://market/mark-to-market/sbi-life-delivers-on-growth-metrics-but-profitability-underwhelms
357,https://market/stock-market-news/dow-slumps-over-360-pts-on-rising-coronavirus-cases-fading-stimulus-hopes-11603721300802.html,4,2,0,2,https://market/stock-market-news/dow-slumps-over-360-pts-on-rising-coronavirus-cases-fading-stimulus-hopes
361,https://money/personal-finance/a-daughter-has-an-equal-right-to-that-of-a-son-on-ancestral-property-11598979896164.html,4,4,1,3,https://money/personal-finance/a-daughter-has-an-equal-right-to-that-of-a-son-on-ancestral-property
364,https://money/personal-finance/ltc-cash-voucher-scheme-return-cash-payout-to-the-employer-if-you-spend-less/amp-11604115122805.html,4,3,0,3,https://money/personal-finance/ltc-cash-voucher-scheme-return-cash-payout-to-the-employer-if-you-spend-less/amp
365,https://money/personal-finance/register-property-release-deed-with-the-sub-registrar-of-assurances/amp-11579601021119.html,4,2,0,2,https://money/personal-finance/register-property-release-deed-with-the-sub-registrar-of-assurances/amp
367,https://mutual-fund/mf-news/sip-inflows-drop-for-6th-month-in-sept-investors-prefer-to-maintain-liquidity-11602590605845.html,4,3,1,2,https://mutual-fund/mf-news/sip-inflows-drop-for-6th-month-in-sept-investors-prefer-to-maintain-liquidity
368,https://news/india/8-ncr-districts-make-up-over-one-third-of-active-coronavirus-cases-in-up/amp-11594227601699.html,4,4,1,3,https://news/india/8-ncr-districts-make-up-over-one-third-of-active-coronavirus-cases-in-up/amp
371,https://news/india/covid-19-update-active-covid-cases-in-india-fall-below-7-lakh-as-nearly-74-000-recover-in-a-day-11603424620149.html,4,2,0,2,https://news/india/covid-19-update-active-covid-cases-in-india-fall-below-7-lakh-as-nearly-74-000-recover-in-a-day
375,https://news/india/india-receives-single-largest-infra-loan-from-kfw-for-mumbai-metro/amp-11604662719908.html,4,4,0,4,https://news/india/india-receives-single-largest-infra-loan-from-kfw-for-mumbai-metro/amp
376,https://news/india/indigo-completes-replacing-pw-engines-powering-its-a320-neo-fleet/amp-11598610472852.html,4,3,1,2,https://news/india/indigo-completes-replacing-pw-engines-powering-its-a320-neo-fleet/amp
378,https://news/india/neet-to-be-held-tomorrow-for-over-15-lakh-candidates-amid-strict-covid-19-precautions-11599913386533.html,4,3,0,3,https://news/india/neet-to-be-held-tomorrow-for-over-15-lakh-candidates-amid-strict-covid-19-precautions
381,https://news/india/the-growing-clamour-for-an-urban-jobs-scheme-11601903485203.html,4,4,0,4,https://news/india/the-growing-clamour-for-an-urban-jobs-scheme
387,https://politics/news/telangana-bjp-appoints-bhupender-yadav-as-election-incharge-for-upcoming-ghmc-polls-11605444842521.html,4,3,1,2,https://politics/news/telangana-bjp-appoints-bhupender-yadav-as-election-incharge-for-upcoming-ghmc-polls
388,https://science/health/covid-19-vaccine-race-spotlight-on-pfizer-moderna-as-trial-data-to-be-released-soon-11601976571287.html,4,4,0,4,https://science/health/covid-19-vaccine-race-spotlight-on-pfizer-moderna-as-trial-data-to-be-released-soon
392,https://v/s/www.livemint.com/news/world/how-jack-ma-blew-ant-s-35-billion-ipo/amp-11605706616879.html?amp_js_v=0.1&usqp=mq331AQFKAGwASA=,4,1,0,1,https://v/s/www.livemint.com/news/world/how-jack-ma-blew-ant-s-35-billion-ipo/amp-11605706616879.html?amp_js_v=0.1&usqp=mq331AQFKAGwASA=
394,https://Companies/IECJ5J1MJS8PTZpkZ439NN/Twitter-says-India-revenue-has-tripled.html,3,2,0,2,companies/IECJ5J1MJS8PTZpkZ439NN/Twitter-says-India-revenue-has-tripled.html
398,https://Companies/vU1NSyLeitWFe3UioxPPvL/Salary-wars-brew-among-top-law-firms.html?facet=amp,3,3,1,2,companies/vU1NSyLeitWFe3UioxPPvL/Salary-wars-brew-among-top-law-firms.html?facet=amp
401,https://Epaper/M/Delhi/20/10/2020/Page/00,3,1,0,1,epaper/M/Delhi/20/10/2020/Page/00
402,https://Home-Page/0xIDW14Y7A41x9IKaWlL2H/docs.google.com/forms/d/e/1FAIpQLScqDRJVOQUGGpZEKSWNei6GIwROSmK8J2n2f4J7dEHAxMmmjg/docs.google.com/forms/d/e/1FAIpQLScqDRJVOQUGGpZEKSWNei6GIwROSmK8J2n2f4J7dEHAxMmmjg/docs.google.com/forms/d/e/1FAIpQLScqDRJVOQUGGpZEKSWNei6GIwROSmK8J2n2f4J7dEHAxMmmjg/docs.google.com/forms/d/e/1FAIpQLScqDRJVOQUGGpZEKSWNei6GIwROSmK8J2n2f4J7dEHAxMmmjg/docs.google.com/forms/d/e/1FAIpQLScqDRJVOQUGGpZEKSWNei6GIwROSmK8J2n2f4J7dEHAxMmmjg/docs.google.com/forms/d/e/1FAIpQLScqDRJVOQUGGpZEKSWNei6GIwROSmK8J2n2f4J7dEHAxMmmjg/docs.google.com/forms/d/e/1FAIpQLScqDRJVOQUGGpZEKSWNei6GIwROSmK8J2n2f4J7dEHAxMmmjg/docs.google.com/forms/d/e/1FAIpQLScqDRJVOQUGGpZEKSWNei6GIwROSmK8J2n2f4J7dEHAxMmmjg/docs.google.com/forms/d/e/1FAIpQLScqDRJVOQUGGpZEKSWNei6GIwROSmK8J2n2f4J7dEHAxMmmjg/docs.google.com/forms/d/e/1FAIpQLScqDRJVOQUGGpZEKSWNei6GIwROSmK8J2n2f4J7dEHAxMmmjg/docs.google.com/forms/d/e/1FAIpQLScqDRJVOQUGGpZEKSWNei6GIwROSmK8J2n2f4J7dEHAxMmmjg/docs.google.com/forms/d/e/1FAIpQLScqDRJVOQUGGpZEKSWNei6GIwROSmK8J2n2f4J7dEHAxMmmjg/docs.google.com/forms/d/e/1FAIpQLScqDRJVOQUGGpZEKSWNei6GIwROSmK8J2n2f4J7dEHAxMmmjg/docs.google.com/forms/d/e/1FAIpQLScqDRJVOQUGGpZEKSWNei6GIwROSmK8J2n2f4J7dEHAxMmmjg/docs.google.com/forms/d/e/1FAIpQLScqDRJVOQUGGpZEKSWNei6GIwROSmK8J2n2f4J7dEHAxMmmjg/docs.google.com/forms/d/e/1FAIpQLScqDRJVOQUGGpZEKSWNei6GIwROSmK8J2n2f4J7dEHAxMmmjg/docs.google.com/forms/d/e/1FAIpQLScqDRJVOQUGGpZEKSWNei6GIwROSmK8J2n2f4J7dEHAxMmmjg/docs.google.com/forms/d/e/1FAIpQLScqDRJVOQUGGpZEKSWNei6GIwROSmK8J2n2f4J7dEHAxMmmjg/docs.google.com/forms/d/e/1FAIpQLScqDRJVOQUGGpZEKSWNei6GIwROSmK8J2n2f4J7dEHAxMmmjg/docs.google.com/forms/d/e/1FAIpQLScqDRJVOQUGGpZEKSWNei6GIwROSmK8J2n2f4J7dEHAxMmmjg/docs.google.com/forms/d/e/1FAIpQLScqDRJVOQUGGpZEKSWNei6GIwROSmK8J2n2f4J7dEHAxMmmjg/docs.google.com/forms/d/e/1FAIpQLScqDRJVOQUGGpZEKSWNei6GIwROSmK8J2n2f4J7dEHAxMmmjg/docs.google.com/forms/d/e/1FAIpQLScqDRJVOQUGGpZEKSWNei6GIwROSmK8J2n2f4J7dEHAxMmmjg/docs.google.com/forms/d/e/1FAIpQLScqDRJVOQUGGpZEKSWNei6GIwROSmK8J2n2f4J7dEHAxMmmjg/docs.google.com/forms/d/e/1FAIpQLScqDRJVOQUGGpZEKSWNei6GIwROSmK8J2n2f4J7dEHAxMmmjg/docs.google.com/forms/d/e/1FAIpQLScqDRJVOQUGGpZEKSWNei6GIwROSmK8J2n2f4J7dEHAxMmmjg/docs.google.com/forms/d/e/1FAIpQLScqDRJVOQUGGpZEKSWNei6GIwROSmK8J2n2f4J7dEHAxMmmjg/docs.google.com/forms/d/e/1FAIpQLScqDRJVOQUGGpZEKSWNei6GIwROSmK8J2n2f4J7dEHAxMmmjg/docs.google.com/forms/d/e/1FAIpQLScqDRJVOQUGGpZEKSWNei6GIwROSmK8J2n2f4J7dEHAxMmmjg/docs.google.com/forms/d/e/1FAIpQLScqDRJVOQUGGpZEKSWNei6GIwROSmK8J2n2f4J7dEHAxMmmjg/docs.google.com/forms/d/e/1FAIpQLScqDRJVOQUGGpZEKSWNei6GIwROSmK8J2n2f4J7dEHAxMmmjg/docs.google.com/forms/d/e/1FAIpQLScqDRJVOQUGGpZEKSWNei6GIwROSmK8J2n2f4J7dEHAxMmmjg/docs.google.com/forms/d/e/1FAIpQLScqDRJVOQUGGpZEKSWNei6GIwROSmK8J2n2f4J7dEHAxMmmjg/docs.google.com/forms/d/e/1FAIpQLScqDRJVOQUGGpZEKSWNei6GIwROSmK8J2n2f4J7dEHAxMmmjg/docs.google.com/forms/d/e/1FAIpQLScqDRJVOQUGGpZEKSWNei6GIwROSmK8J2n2f4J7dEHAxMmmjg/docs.google.com/forms/d/e/1FAIpQLScqDRJVOQUGGpZEKSWNei6GIwROSmK8J2n2f4J7dEHAxMmmjg/docs.google.com/forms/d/e/1FAIpQLScqDRJVOQUGGpZEKSWNei6GIwROSmK8J2n2f4J7dEHAxMmmjg/docs.google.com/forms/d/e/1FAIpQLScqDRJVOQUGGpZEKSWNei6GIwROSmK8J2n2f4J7dEHAxMmmjg/viewform?embedded=true,3,1,0,1,home-page/0xIDW14Y7A41x9IKaWlL2H/docs.google.com/forms/d/e/1FAIpQLScqDRJVOQUGGpZEKSWNei6GIwROSmK8J2n2f4J7dEHAxMmmjg/docs.google.com/forms/d/e/1FAIpQLScqDRJVOQUGGpZEKSWNei6GIwROSmK8J2n2f4J7dEHAxMmmjg/docs.google.com/forms/d/e/1FAIpQLScqDRJVOQUGGpZEKSWNei6GIwROSmK8J2n2f4J7dEHAxMmmjg/docs.google.com/forms/d/e/1FAIpQLScqDRJVOQUGGpZEKSWNei6GIwROSmK8J2n2f4J7dEHAxMmmjg/docs.google.com/forms/d/e/1FAIpQLScqDRJVOQUGGpZEKSWNei6GIwROSmK8J2n2f4J7dEHAxMmmjg/docs.google.com/forms/d/e/1FAIpQLScqDRJVOQUGGpZEKSWNei6GIwROSmK8J2n2f4J7dEHAxMmmjg/docs.google.com/forms/d/e/1FAIpQLScqDRJVOQUGGpZEKSWNei6GIwROSmK8J2n2f4J7dEHAxMmmjg/docs.google.com/forms/d/e/1FAIpQLScqDRJVOQUGGpZEKSWNei6GIwROSmK8J2n2f4J7dEHAxMmmjg/docs.google.com/forms/d/e/1FAIpQLScqDRJVOQUGGpZEKSWNei6GIwROSmK8J2n2f4J7dEHAxMmmjg/docs.google.com/forms/d/e/1FAIpQLScqDRJVOQUGGpZEKSWNei6GIwROSmK8J2n2f4J7dEHAxMmmjg/docs.google.com/forms/d/e/1FAIpQLScqDRJVOQUGGpZEKSWNei6GIwROSmK8J2n2f4J7dEHAxMmmjg/docs.google.com/forms/d/e/1FAIpQLScqDRJVOQUGGpZEKSWNei6GIwROSmK8J2n2f4J7dEHAxMmmjg/docs.google.com/forms/d/e/1FAIpQLScqDRJVOQUGGpZEKSWNei6GIwROSmK8J2n2f4J7dEHAxMmmjg/docs.google.com/forms/d/e/1FAIpQLScqDRJVOQUGGpZEKSWNei6GIwROSmK8J2n2f4J7dEHAxMmmjg/docs.google.com/forms/d/e/1FAIpQLScqDRJVOQUGGpZEKSWNei6GIwROSmK8J2n2f4J7dEHAxMmmjg/docs.google.com/forms/d/e/1FAIpQLScqDRJVOQUGGpZEKSWNei6GIwROSmK8J2n2f4J7dEHAxMmmjg/docs.google.com/forms/d/e/1FAIpQLScqDRJVOQUGGpZEKSWNei6GIwROSmK8J2n2f4J7dEHAxMmmjg/docs.google.com/forms/d/e/1FAIpQLScqDRJVOQUGGpZEKSWNei6GIwROSmK8J2n2f4J7dEHAxMmmjg/docs.google.com/forms/d/e/1FAIpQLScqDRJVOQUGGpZEKSWNei6GIwROSmK8J2n2f4J7dEHAxMmmjg/docs.google.com/forms/d/e/1FAIpQLScqDRJVOQUGGpZEKSWNei6GIwROSmK8J2n2f4J7dEHAxMmmjg/docs.google.com/forms/d/e/1FAIpQLScqDRJVOQUGGpZEKSWNei6GIwROSmK8J2n2f4J7dEHAxMmmjg/docs.google.com/forms/d/e/1FAIpQLScqDRJVOQUGGpZEKSWNei6GIwROSmK8J2n2f4J7dEHAxMmmjg/docs.google.com/forms/d/e/1FAIpQLScqDRJVOQUGGpZEKSWNei6GIwROSmK8J2n2f4J7dEHAxMmmjg/docs.google.com/forms/d/e/1FAIpQLScqDRJVOQUGGpZEKSWNei6GIwROSmK8J2n2f4J7dEHAxMmmjg/docs.google.com/forms/d/e/1FAIpQLScqDRJVOQUGGpZEKSWNei6GIwROSmK8J2n2f4J7dEHAxMmmjg/docs.google.com/forms/d/e/1FAIpQLScqDRJVOQUGGpZEKSWNei6GIwROSmK8J2n2f4J7dEHAxMmmjg/docs.google.com/forms/d/e/1FAIpQLScqDRJVOQUGGpZEKSWNei6GIwROSmK8J2n2f4J7dEHAxMmmjg/docs.google.com/forms/d/e/1FAIpQLScqDRJVOQUGGpZEKSWNei6GIwROSmK8J2n2f4J7dEHAxMmmjg/docs.google.com/forms/d/e/1FAIpQLScqDRJVOQUGGpZEKSWNei6GIwROSmK8J2n2f4J7dEHAxMmmjg/docs.google.com/forms/d/e/1FAIpQLScqDRJVOQUGGpZEKSWNei6GIwROSmK8J2n2f4J7dEHAxMmmjg/docs.google.com/forms/d/e/1FAIpQLScqDRJVOQUGGpZEKSWNei6GIwROSmK8J2n2f4J7dEHAxMmmjg/docs.google.com/forms/d/e/1FAIpQLScqDRJVOQUGGpZEKSWNei6GIwROSmK8J2n2f4J7dEHAxMmmjg/docs.google.com/forms/d/e/1FAIpQLScqDRJVOQUGGpZEKSWNei6GIwROSmK8J2n2f4J7dEHAxMmmjg/docs.google.com/forms/d/e/1FAIpQLScqDRJVOQUGGpZEKSWNei6GIwROSmK8J2n2f4J7dEHAxMmmjg/docs.google.com/forms/d/e/1FAIpQLScqDRJVOQUGGpZEKSWNei6GIwROSmK8J2n2f4J7dEHAxMmmjg/docs.google.com/forms/d/e/1FAIpQLScqDRJVOQUGGpZEKSWNei6GIwROSmK8J2n2f4J7dEHAxMmmjg/docs.google.com/forms/d/e/1FAIpQLScqDRJVOQUGGpZEKSWNei6GIwROSmK8J2n2f4J7dEHAxMmmjg/docs.google.com/forms/d/e/1FAIpQLScqDRJVOQUGGpZEKSWNei6GIwROSmK8J2n2f4J7dEHAxMmmjg/viewform?embedded=true
404,https://Home/MShareImage?Pictureid=1911c8c620a8,3,2,0,2,home/MShareImage?Pictureid=1911c8c620a8
405,https://Home/mIndex?_we_linker=1*9ib7d7*we_luid*YW1wLWZQdFAwemlXZzhnbS1veWJjZmwtT0E.,3,1,0,1,home/mIndex?_we_linker=1*9ib7d7*we_luid*YW1wLWZQdFAwemlXZzhnbS1veWJjZmwtT0E.
407,https://Industry/heHyiUVLG806xv37Ltfm5M/Reliance-Industries-emerges-sole-contender-to-acquire-stake.html?facet=amp,3,2,0,2,industry/heHyiUVLG806xv37Ltfm5M/Reliance-Industries-emerges-sole-contender-to-acquire-stake.html?facet=amp
413,https://Leisure/rzDZikAcCrjpmuiw8lHEVL/Stories-we-dont-hear.html?facet=amp,3,1,0,1,leisure/rzDZikAcCrjpmuiw8lHEVL/Stories-we-dont-hear.html?facet=amp
416,https://Money/Hs14rr4STCHrZhc9OzS3DM/Palani-Hills-may-lose-unique-banana-varieties-to-virus.html?facet=amp,3,1,0,1,money/Hs14rr4STCHrZhc9OzS3DM/Palani-Hills-may-lose-unique-banana-varieties-to-virus.html?facet=amp
419,https://Money/iQBsfungcPZKA2kVglgm7H/Why-you-should-use-the-RERA-website-before-buying-property.html,3,3,1,2,money/iQBsfungcPZKA2kVglgm7H/Why-you-should-use-the-RERA-website-before-buying-property.html
422,https://Opinion/HziUVKc2XnZxidRD3rjqVL/Rural-income-looking-beyond-agriculture.html,3,3,1,2,opinion/HziUVKc2XnZxidRD3rjqVL/Rural-income-looking-beyond-agriculture.html
427,https://Politics/5HU9KriaUIbYUaPdvdvtsO/www.thinglink.com/card/www.thinglink.com/card/www.thinglink.com/card/www.thinglink.com/card/www.thinglink.com/card/www.thinglink.com/card/www.thinglink.com/card/www.thinglink.com/card/www.thinglink.com/card/www.thinglink.com/card/www.thinglink.com/card/www.thinglink.com/card/www.thinglink.com/card/www.thinglink.com/card/www.thinglink.com/card/www.thinglink.com/card/www.thinglink.com/card/www.thinglink.com/card/www.thinglink.com/card/www.thinglink.com/card/www.thinglink.com/card/www.thinglink.com/card/www.thinglink.com/card/www.thinglink.com/card/www.thinglink.com/card/www.thinglink.com/card/www.thinglink.com/card/www.thinglink.com/card/www.thinglink.com/card/www.thinglink.com/card/www.thinglink.com/card/www.thinglink.com/card/www.thinglink.com/card/www.thinglink.com/card/www.thinglink.com/card/www.thinglink.com/card/www.thinglink.com/card/www.thinglink.com/card/www.thinglink.com/card/www.thinglink.com/card/www.thinglink.com/card/www.thinglink.com/card/www.thinglink.com/card/www.thinglink.com/card/www.thinglink.com/card/www.thinglink.com/card/www.thinglink.com/card/www.thinglink.com/card/www.thinglink.com/card/www.thinglink.com/card/www.thinglink.com/card/www.thinglink.com/card/www.thinglink.com/card/www.thinglink.com/card/www.thinglink.com/card/www.thinglink.com/card/www.thinglink.com/card/www.thinglink.com/card/www.thinglink.com/card/www.thinglink.com/card/www.thinglink.com/card/www.thinglink.com/card/www.thinglink.com/card/www.thinglink.com/card/www.thinglink.com/card/www.thinglink.com/card/www.thinglink.com/card/www.thinglink.com/card/www.thinglink.com/card/www.thinglink.com/card/www.thinglink.com/card/www.thinglink.com/card/www.thinglink.com/card/www.thinglink.com/card/www.thinglink.com/card/www.thinglink.com/card/www.thinglink.com/card/www.thinglink.com/card/www.thinglink.com/card/www.thinglink.com/card/www.thinglink.com/card/www.thinglink.com/card/www.thinglink.com/card/www.thinglink.com/card/www.thinglink.com/card/www.thinglink.com/card/www.thinglink.com/card/611491258145177600,3,2,0,2,politics/5HU9KriaUIbYUaPdvdvtsO/www.thinglink.com/card/www.thinglink.com/card/www.thinglink.com/card/www.thinglink.com/card/www.thinglink.com/card/www.thinglink.com/card/www.thinglink.com/card/www.thinglink.com/card/www.thinglink.com/card/www.thinglink.com/card/www.thinglink.com/card/www.thinglink.com/card/www.thinglink.com/card/www.thinglink.com/card/www.thinglink.com/card/www.thinglink.com/card/www.thinglink.com/card/www.thinglink.com/card/www.thinglink.com/card/www.thinglink.com/card/www.thinglink.com/card/www.thinglink.com/card/www.thinglink.com/card/www.thinglink.com/card/www.thinglink.com/card/www.thinglink.com/card/www.thinglink.com/card/www.thinglink.com/card/www.thinglink.com/card/www.thinglink.com/card/www.thinglink.com/card/www.thinglink.com/card/www.thinglink.com/card/www.thinglink.com/card/www.thinglink.com/card/www.thinglink.com/card/www.thinglink.com/card/www.thinglink.com/card/www.thinglink.com/card/www.thinglink.com/card/www.thinglink.com/card/www.thinglink.com/card/www.thinglink.com/card/www.thinglink.com/card/www.thinglink.com/card/www.thinglink.com/card/www.thinglink.com/card/www.thinglink.com/card/www.thinglink.com/card/www.thinglink.com/card/www.thinglink.com/card/www.thinglink.com/card/www.thinglink.com/card/www.thinglink.com/card/www.thinglink.com/card/www.thinglink.com/card/www.thinglink.com/card/www.thinglink.com/card/www.thinglink.com/card/www.thinglink.com/card/www.thinglink.com/card/www.thinglink.com/card/www.thinglink.com/card/www.thinglink.com/card/www.thinglink.com/card/www.thinglink.com/card/www.thinglink.com/card/www.thinglink.com/card/www.thinglink.com/card/www.thinglink.com/card/www.thinglink.com/card/www.thinglink.com/card/www.thinglink.com/card/www.thinglink.com/card/www.thinglink.com/card/www.thinglink.com/card/www.thinglink.com/card/www.thinglink.com/card/www.thinglink.com/card/www.thinglink.com/card/www.thinglink.com/card/www.thinglink.com/card/www.thinglink.com/card/www.thinglink.com/card/www.thinglink.com/card/www.thinglink.com/card/www.thinglink.com/card/611491258145177600
430,https://Politics/Rn0AWNC5CzHYOmlAum0jTK/Increase-in-floor-area-ratio-for-Delhi-approved.html?facet=amp,3,3,1,2,politics/Rn0AWNC5CzHYOmlAum0jTK/Increase-in-floor-area-ratio-for-Delhi-approved.html?facet=amp
435,https://Search/Link/Keyword/Idbi-Bank-Npa,3,2,0,2,search/Link/Keyword/Idbi-Bank-Npa
437,https://Search/Link/Keyword/housing,3,1,0,1,search/Link/Keyword/housing
438,https://Sundayapp/FU6sreM7t13piRRwkvdKfP/Secularism-and-principled-distance-How-Hinduism-was-nationa.html,3,3,1,2,sundayapp/FU6sreM7t13piRRwkvdKfP/Secularism-and-principled-distance-How-Hinduism-was-nationa.html
439,https://Technology/mvpdtX5SVUAHeClRAtBfuJ/PostCES-19-Will-gaming-laptops-finally-interest-progamer.html?facet=amp,3,3,1,2,technology/mvpdtX5SVUAHeClRAtBfuJ/PostCES-19-Will-gaming-laptops-finally-interest-progamer.html?facet=amp
444,https://companies/news/ael-plans-50-000-cr-capital-expenditure-over-five-years/amp-11604539879474.html,3,3,1,2,https://companies/news/ael-plans-50-000-cr-capital-expenditure-over-five-years/amp
451,https://companies/news/oyo-plans-to-reinstate-employee-salaries-in-a-phased-manner/amp-11596562966934.html,3,3,1,2,https://companies/news/oyo-plans-to-reinstate-employee-salaries-in-a-phased-manner/amp
453,https://companies/news/sony-viacom18-deal-by-mid-aug-11595980721928.html,3,3,0,3,https://companies/news/sony-viacom18-deal-by-mid-aug
454,https://companies/news/the-pill-economy-of-india-s-online-medicos-11572794132893.html,3,2,0,2,https://companies/news/the-pill-economy-of-india-s-online-medicos
455,https://companies/news/what-makes-jio-platforms-command-a-rs-5-trillion-valuation/amp-11588736360741.html,3,3,0,3,https://companies/news/what-makes-jio-platforms-command-a-rs-5-trillion-valuation/amp
456,https://companies/people/arvind-fashion-appoints-shailesh-chaturvedi-as-md-and-ceo-11605181074520.html,3,3,1,2,https://companies/people/arvind-fashion-appoints-shailesh-chaturvedi-as-md-and-ceo
457,https://companies/people/simple-man-of-simple-tastes-leads-disciplined-not-lavish-lifestyle-anil-ambani/amp-11601103098906.html,3,3,0,3,https://companies/people/simple-man-of-simple-tastes-leads-disciplined-not-lavish-lifestyle-anil-ambani/amp
458,https://companies/start-ups/for-nykaa-fashion-is-the-next-biggest-frontier/amp-11597405792384.html,3,3,0,3,https://companies/start-ups/for-nykaa-fashion-is-the-next-biggest-frontier/amp
460,https://education/news/mbbs-fees-in-medical-colleges-raised-in-haryana-from-rs-50-000-to-rs-10-lakh-per-year-11605139064519.html?fbclid=IwAR3PNdsXpiaDeN3WHkBgIwcvKKfJrBh-Kpin-RvaC8Nu_RhRHzXSZMilRAo,3,1,0,1,https://education/news/mbbs-fees-in-medical-colleges-raised-in-haryana-from-rs-50-000-to-rs-10-lakh-per-year-11605139064519.html?fbclid=IwAR3PNdsXpiaDeN3WHkBgIwcvKKfJrBh-Kpin-RvaC8Nu_RhRHzXSZMilRAo
461,https://https://www.livemint.com/photos/apple-event-highlights-in-pictures-1568143993788-3.html,3,2,0,2,https/www.livemint.com/photos/apple-event-highlights-in-pictures-1568143993788-3.html
462,https://industry/banking/central-bank-of-india-net-loss-narrows-to-rs-1-529-crore-in-q4/amp-11593430836570.html,3,3,1,2,https://industry/banking/central-bank-of-india-net-loss-narrows-to-rs-1-529-crore-in-q4/amp
463,https://industry/banking/page-8,3,2,0,2,industry/banking/page-8
464,https://industry/banking/treasury-income-to-support-banks-profitability-in-fiscal-2021-11592915824535.html,3,2,0,2,https://industry/banking/treasury-income-to-support-banks-profitability-in-fiscal-2021
465,https://industry/human-resource/sail-new-pension-scheme-current-former-employees/amp-1556684788108.html,3,3,1,2,industry/human-resource/sail-new-pension-scheme-current-former-employees/amp-1556684788108.html
466,https://industry/manufacturing/page-2,3,3,0,3,industry/manufacturing/page-2
467,https://industry/retail/amazon-india-expands-grocery-offering-to-new-cities-11604569151145.html,3,3,0,3,https://industry/retail/amazon-india-expands-grocery-offering-to-new-cities
469,https://insurance/news/test-story-budget-highlights-11579067382744.html,3,1,0,1,https://insurance/news/test-story-budget-highlights
470,https://market/commodities/gold-prices-today-rise-for-3rd-day-but-still-down-rs-5000-from-record-highs-11603249753696.html,3,2,0,2,https://market/commodities/gold-prices-today-rise-for-3rd-day-but-still-down-rs-5000-from-record-highs
471,https://market/mark-to-market/ambuja-cement-s-capacity-constraint-to-ease-but-cash-flow-may-become-a-concern-11603426062721.html,3,3,1,2,https://market/mark-to-market/ambuja-cement-s-capacity-constraint-to-ease-but-cash-flow-may-become-a-concern
472,https://market/mark-to-market/paints-margins-to-shine-as-crude-price-eases-volume-recovery-may-take-time/amp-1560273014136.html,3,1,0,1,market/mark-to-market/paints-margins-to-shine-as-crude-price-eases-volume-recovery-may-take-time/amp-1560273014136.html
473,https://market/market-stats/company-bse-tata-steel-ltd-100470,3,1,0,1,market/market-stats/company-bse-tata-steel-ltd-100470
474,https://market/stock-market-news/hindalco-up-3-after-novelis-closes-sale-of-former-aleris-plant-in-belgium-11601891837016.html,3,2,0,2,https://market/stock-market-news/hindalco-up-3-after-novelis-closes-sale-of-former-aleris-plant-in-belgium
477,https://mint-lounge/business-of-life/why-some-ceos-don-t-care-about-mbas-11578497893474.html,3,1,0,1,https://mint-lounge/business-of-life/why-some-ceos-don-t-care-about-mbas
479,https://mint-lounge/features/opinion-netflix-hotstar-or-amazon-1549603427357.html,3,1,0,1,mint-lounge/features/opinion-netflix-hotstar-or-amazon-1549603427357.html
483,https://money/personal-finance/gap-between-bank-fixed-deposits-and-small-savings-schemes-widens-11601531543278.html,3,3,1,2,https://money/personal-finance/gap-between-bank-fixed-deposits-and-small-savings-schemes-widens
487,https://money/personal-finance/sebi-bans-upfront-distributor-commissions-in-pms-introduces-direct-plans/amp-11581654805922.html,3,3,0,3,https://money/personal-finance/sebi-bans-upfront-distributor-commissions-in-pms-introduces-direct-plans/amp
488,https://money/personal-finance/three-regulation-changes-that-make-mutual-funds-safer-11602606084418.html,3,3,1,2,https://money/personal-finance/three-regulation-changes-that-make-mutual-funds-safer
489,https://mutual-fund/mf-news/bharat-bond-etf-10-things-to-know-about-india-s-first-corporate-bond-etf/amp-11575456164892.html,3,3,0,3,https://mutual-fund/mf-news/bharat-bond-etf-10-things-to-know-about-india-s-first-corporate-bond-etf/amp
492,https://news/india/air-india-express-flight-with-180-passengers-skids-on-runway-at-kozhikode-airport-11596813128851.html,3,3,0,3,https://news/india/air-india-express-flight-with-180-passengers-skids-on-runway-at-kozhikode-airport
493,https://news/india/babri-masjid-demolition-case-all-32-accused-including-lk-advani-acquitted-11601441403657.html,3,2,0,2,https://news/india/babri-masjid-demolition-case-all-32-accused-including-lk-advani-acquitted
494,https://news/india/centre-raises-excise-duty-on-petrol-by-rs-10-per-litre-and-on-diesel-by-rs-13-11588701701672.html,3,2,0,2,https://news/india/centre-raises-excise-duty-on-petrol-by-rs-10-per-litre-and-on-diesel-by-rs-13
496,https://news/india/covid-19-pm-modi-reviews-situation-with-cms-of-states-with-high-caseload/amp-11600866975964.html,3,3,1,2,https://news/india/covid-19-pm-modi-reviews-situation-with-cms-of-states-with-high-caseload/amp
499,https://news/india/frauds-rise-as-india-s-economy-slows-11575957308723.html,3,3,0,3,https://news/india/frauds-rise-as-india-s-economy-slows
